% Amigos atal madre: aguardar la deuemos
Sy a ella serujeremos: nuestra pro buscaremos
Honrraremos los cuerpos: las almas saluaremos
Por poco de serujçio: grant galardon resçibremos
% gos si quisierdes: vn poco esperar
otro mjraglo: uos quiero contar
sancta maria: quiso dios demostrar
De che quiso: con su boca marcar
% Vn monge bendicto: fue en vna mongia
El logar non lo leo: dezir non lo sabria
Queria de coraçon: bien a sancta maria
Ffazia ala su ymagen: reuerençia cada dia
% Ffincaua los ynoios: e dizia aue maria
El abbat dela casa: dioli la sacristania
Ca tenjalo por cuerdo: e quito de folia
Ffazia ala su statua: el Jnclin cada dia
% El enemjgo malo: de belzebub ujcario
Que siempre fue e es: delos buenos contrario
Tanto podio bullir: el subtil ad+uersario
Que corronpio al monge: e fizo lo fornjcario
% Tomo vn uso malo: el loco peccador
De noche quando era: echado el prior
Salia por la iglesia: fuera del dormjtor
Corria el entorpado: ala mala lauor
% Sy quier ala salida: si quier ala entrada
Delante del altar: li cadia la passada
El Jnclin e la aue: tenja bien usada
Non seli olbidaua: en njnguna uegada
% Corria vn rio bueno: çerca dela mongia
Auja lo de passar: el monge cada dia
Do se uenja el loco: de conplir su folia
Cadio en+fogosse: fuera dela freyria
% Quando vjno la hora: de matines tocar
Non auja sacristano: que podiesse sonar
Levantaron se todos: cada vno de su logar
Ffueron ala iglesia: al monge despertar
% Abrieron la iglesia: commo meior sopieron
Buscaron al clauero: fallar no lo podieron
Buscando suso e yuso: atanto andidieron
Do jazia enfogado: alla lo en firieron
% Que podria seer esto: no lo podrian asmar
Sy se murio o lo mataron: nolo sabian Juzgar
Era muy grande la uasca: e mayor el pesar
Ca cadia en mal preçio: por elli. el logar
% Mientre iazia en uanno: el cuerpo en el rio
Diremos del alma: en qual pleyto se ujo
Vnjeron de diablos: ella grant gentio
Por leuar la al baranco: de deleyte bien uazio
% Mientre quelos diablos: la trayan commo a pella
Vieronla los angeles: descendieron a ella
Ffizieron los diablos: luego muy grant querella
Que suya era quita: que se partiessen della
% Non oujeron los angeles: razon de bozearla
Ca ouo la fin mala: e atal fue sin falla
Tirar non lis podieron: valiente vna agalla
Obieron apartirse: tristes dela batalla
% Acorriol la gloriosa: reyna general
Ca tenjan los diablos: mjentes atodo mal
Mandolis attender: non osaron fer al
Moujolis pleitesia: firme e muy cabdal
% Propuso la gloriosa: palabra colorada
Con esta alma locos: uos non auedes nada
Mientre fue en el cuerpo: fue mj acomendada
Agora prendria tuerto: por yr desemparada
% Dela otra partida: respondio el uozero
Vn sabidor diablo: sotil. e muy puntero
Madre eres del fijo: alcalde derechero
Que nol plaze la fuerça: njn es ende plazentero
% Escripto es que el omne: alli do es fallado
O en bien. o en mal: por ello es Juzgado
Sy este tal decreto: por ti fuere falsado
El pleyto del euangelio: todo es desado
% Ffablas diz la gloriosa: agujs de cosa nesçia
Non te rieto: ca eres: vna captiua bestia
Quando salio de casa: de mj tomo liçençja
Del peccado que fizo: yol dare penjtençia
% Ternja en fer uos fuerça: non buena parecencia
Mas appello adon: ala su audiençia
El que es poderoso: lleno de sapiençia
Dela su boca qujero: oyr esta sentençia
% El Rey delos çielos: alcalde sabidor
Partio esta contienda: nunca ujestes meior
Mando tornar el alma: al cuerpo el sennor
Desende qual meresçiesse: reçebria tal honor
% Estaua el conuento: triste. e desalmado
Por este mal exiemplo: que l era ubiado
Resusçito el cuerpo: que era ya passado
Espantaron se todos: ca era agujsado
% Ffablolis el buen omne: dixolis conpanneros
Muerto fuj. e so ujuo: desto seet çerteros
Grado ala gloriosa: que salua sus obreros
Que me libro de manos: delos malos guerreros
% Contolis por su lengua: toda la ledanja
Que dizian los diablos: e que sancta maria
Como lo qujto ella: de su podestadia
Sy por ella no fuesse: era en negro dia
% Rendieron todos gracias: de toda voluntat
A la sancta reygna: madre de piadat
Que fizo tal mjraglo: por su benjgnjdat
Por que esta mas firme: toda la xristiandat
% Confesso sse el monge: e fizo penjtençia
Meiorosse de toda: su mala contenençia
Serujo ala gloriosa: mjentre ouo potençia
Resqujescat Jn pace: cum diujna potençia
% Muchos tales mjraglos: e muchos mas granados
Ffizo sancta maria: sobre sus aclamados
Non serian los mjlesmos: por mil omnes contados
LEemos de vn clerigo: que era testerido
En los ujçios seglares: dura mente enbeujdo
Pero que era loco: auja vn buen sentido
Auia la gloriosa: de coraçon conplido
% Como quiera. que era: en el mal acostunbrado
En saludar al gloriosa: era bien acordado
Non iria a iglesia: njn a otro mandado
Que el su nonbre ante: non fuesse aclamado
% Dezir non lo sabria: sobre qual ocasion
Ca nos non lo sabemos: si lo busco o non
Dieron le enemjgos: salto a este baron
Oujeron amatarlo: dele dios perdon
% Los omnes dela ujlla: e los sus conpanneros
Esto commo cuntiera: non eran çerteros
De fuera dela villa: entre vnos riberos
Alla lo soterraron: non entre los dezmeros
% Pesole ala gloriosa: con este enterramjento
Que yazia el su sieruo: fuera de su conujento
Apareçiol a vn clerigo: de buen entendimjento
Dixoli que fizieran: en ello fallimjento
...
Sy estos çinco sesos: que dicho uos auemos
Ala madre gloriosa: bien gelos offresçemos
Del yerro. que por estos: çinco sesos faremos
Por el su sancto ruego: grant perdon ganaremos
% Enfermo este clerigo: de muy fuerte manera
Queli querian los ojos: salir dela mollera
Tenja que era toda: conplida la carrera
E queli uenia çerca: la hora postrimera
% Aparescioli la madre: del rey çelestial
Que en mjsericordia: nunca ouo egual
Amjgo dixo. salue te: el sennor spirital
De cuya madre fuisti: tu amjgo leal
% Esfuerça te non temas: non seas desmarrido
Sepas seras ayna: desta dolor guarido
Tente con dios a vna: por de cuyta salido
Que dizelo el tu pulso: que es bueno cunplido
% Yo çerca de ti estando: tu non ayas pauor
Tente por meiorado: de toda la dolor
Resçibi de ti siempre: serujcio. e honor
Dar te quiero el preçio: de lauor
% Bien se cuydo el clerigo: del lecho leuantar
E que podria por campo: en sus piedes andar
Mas a grant diferençia: de sauer acujdar
Ouo se otra gujsa: esto atermjnar
% Bien se cujdo el clerigo: dela presion salir
E con sus conosçientes: de portar e reyr
Mas non podio el alma: tal plazo reçebir
Desemparo el cuerpo: ouo ende a salir
% Tomola la gloriosa: delos çielos reyna
Ffuesse la afijada: conla buena madrina
Tomaron la los angeles: conla gracia diujna
Leuaron la al çielo: do el bien nunca fina
% La madre gloriosa: lo que li prometio
Benedicta sea ella: ca bien gelo cunplio
Como lo dizia ella: el non lo entendio
Mas en quanto que dixo: uerdadera salio
% Quando la uoz oyeron: e ujeron la cosa
Todos tenjan que fizo: mjraglo la gloriosa
Tenjan que fue el clerigo: de uentura donosa
Glorificauan la todos: ala uirgo gloriosa
ERa un omne pobre: que ujuja de raciones
Non auja rendas: nj otras effurçiones
Ffuera quando labraua: esto pocas sazones
Tenja en su alçado: pocos de pipiones
% Por ganar la gloriosa: que el mucho amaua
Partia conlos pobres: quanto que ganaua
Enesto contendia: e enesto punaua
Por ganar su gracia: la mengua olbidaua
% Quando ouo este pobre: desti mundo a passar
La madre gloriosa: ujno lo conujdar
Ffabloli muy sabroso: querialo falagar
Oyeron la palabra: todos los del logar
% Tu mucho copdiçieste: la nuestra conpannja
Sopisti para ganar: muy buena maestria
Que partias tus limosnas: dizias aue maria
Por que lo fazias todo: yo bien lo sabia
% Sepas que es tu cosa: toda bien recapdada
Esta es en que somos: la cabera iornada
El ite mjssa est: conta que es cantada
Venjda es la hora: de tomar la soldada
% Yo so aquj uenjda: por leuar te comjgo
Al regno de mj fijo: que es bien tu amjgo
Do se çeuan los angeles: del buen candeal trigo
Alas sanctas uirtudes: plazer les ha contigo
% Quando ouo la gloriosa: el sermon acabado
Desampara el alma: al cuerpo uenturado
Tomaron la de angeles: vn conuento ondrado
Leuaron la al çielo: dios sea loado
% Los omnes que aujan: la uoz ante oyda
Tan ayna ujeron: la promessa conplida
Ala madre gloriosa: ques tan comedida
Todos li rendian gracias: quisque de su partida
% Quj tal cosa ujdiesse: seria mal uenturado
Sy de sancta maria: non fuesse mas pagado
Sy mas non la honrasse: seria desmesurado
Quj de ella se parte: es muy mal engannado
% Aun mas adelante: queremos aguyiar
Tal razon como esta: no es de destaiar
Ca estos son los arboles: do deuemos folgar
En cuya sonbra suelen: las aues organar
ERa vn ladron malo: que mas queria furtar
Que yr ala iglesia: njn apuentes alçar
Sabia de mal percanço: su casa gobernar
Vso malo que tomo: nolo podia dexar
% Sy fazia otros males: esto non lo leemos
Seria mal condempnar lo: por lo que non sabemos
Mas abonde nos esto: que dicho uos auemos
Sy al fizo perdoneli: xpistus en quj creemos
% Entre las otras malas: auja vna bondat
Queli ualio en cabo: e dioli saluedat
Credia en la gloriosa: de toda uoluntat
Saludauala siempre: contra la su magestat
% Dizia aue maria: e mas de escriptura
Siempre se Jnclinaua: contra la su figura
Dizia aue maria: e mas de escriptura
Tenja su voluntat: con esto mas segura
% Como quj en mal anda: en mal ha a caer
Oujeron lo con furto: a este ladron a prender
Non ouo nul conseio: con que se defender
Juzgaron que lo fuessen: enla forca poner
% Leuolo el conçeio: para la crucijada
Do estaua la forca: por conçeio parada
Cerraron li los oios: con toca bien atada
Alçaron lo de tierra: con soga bien tirada
% Alçaron lo de tierra: quanto alçar quisieron
Quantos cerca estauan: por muerto lo toujeron
Sy ante lo sopiessen: lo que depues sopieron
Noli aujeran fecho: esso que li fizieron
% La madre gloriosa: ducha de acorrer
Que suele asus sieruos: enlas cuytas ualer
A este condempnado: qujsoli pro tener
Menbroli el serujçio: que solia fazer
% Metioli solos piedes: do estaua colgado
Las sus manos preçiosas: touolo alli ujado
Non se sentio: de njnguna cosa enbargado
Non estouo mas ujçioso: nj nunca mas pagado
% Dende al dia terçero: ujnjeron sus parientes
Vinjeron los amjgos: e los bien querientes
Vinjan por descolgarlo: rascados. e dolientes
Estaua meior la cosa: que non parauan mjentes
% Ffallaron lo con alma: alegre. e sin danno
Non seria tan ujçioso: sy yogujesse en banno
Dizia que solos piedes: tenja vn tal escanno
Non sintria mal njnguno: si colgasse vn anno
% Quando lo entendieron: los qui lo enforcaron
Toujeron que el lazo: floxo gelo dexaron
Ffueron mal repentidos: que nolo degollaron
Tanto gozaran de esso: quanto depues gozaron
% Ffueron en v
Que fuero
Mas quel
Por vn la
% Ffueron
Conbi
Met
Ffin
% Qua
Q
O
F
%
s sano
o
on
% Madre dixo don xpisto: yo sauer querria
Que negoçio uos trae: con esta conpannja
Ffijo dixo la madre: a rogar uos uenja
Por alma de vn monge: de fulana mongia
% Madre dixo el fijo: non seria derechura
Tal alma de tal omne: entrar en tal folgura
Seria menoscauada: toda la escriptura
Mas por el uuestro ruego: faremos y mesura
% Qujero fazer atanto: por el uuestro amor
Torne aun al cuerpo: en quj fue morador
Ffaga su penjtençia: como faz peccador
E pueda seer saluo: por manera meior
% Quando oyo sant pedro: este tan dulze mandado
Vio que su negoçio: era bien recapdado
Torno alos diablos: conçeio en+conado
La alma que leuauan: qujtogela syn grado
% Diola a dos njnnos: de muy grant claridat
Creaturas angelicas: de muy grant sanctidat
Diogela en comjenda: de toda uoluntat
Por tornar la al cuerpo: grant seguridat
% Dieron gela los njnnos: aun frayre honrrado
Que fuera en su orden: de chiqujnez criado
Leuola al cuerpo: que yazia amortaiado
Resusçito el monge: dios sea ende loado
% Al alma del monge: dixoli la su guya
El fraire omne buen: que ante nos dizia
Yo te ruego por dios: e por sancta maria
Que tengas vn clamor: tu por mj cada dia
% Otra cosa te ruego: que la mj sepultura
Que yaze toda cubierta: de suso la bassura
Tu la fagas barrer: por la tu buena mesura
Tu lo cumpli: sy dios te de buena uentura
% Resusçito el monge: el que fuera transido
Pero. por vn grant dia: souo fuerte esido
Maguer torno en cabo: en todo su sentido
E declaro al conuento: por que auja troçido
% Rendieron a dios gracias: ala virgo real
E al sancto apostolo: clauero çelestial
Que por saluar su monge: suffrio porfazo tal
Non fue esti mjraglo: de preçio siuuel+qual
% Non aya nadi dubda: entre su coraçon
Non diga esta cosa: podria seer o non
Ponga e ala gloriosa: todo su coraçon
Entendra que non ujene: esto contra razon
% Commo es la gloriosa: plena de bendiçion
Es plena de gracia: e qujta de Jndiçion
Nol seria denegada: njnguna petiçion
Nol diria tal fijo: atal madre de non
SEnnores e amjgos: por dios e caridat
Oyt otro mjraglo: fermoso por uerdat
Sant hugo lo escriujo: de clunnjego abbat
Que conteçio avn monge: de su soçiedat
% Vn monge de su casa: guyralte era llamado
Ante que fuesse monge: era non muy ensennado
Ffazia alas deuezes: follia. e peccado
Como omne soltero: que non es apremjado
% Vinol en coraçon: do estaua vn dia
Al apostol de espanna: de yr en romeria
Enderesço su fazienda: busco su conpannja
Destaiaron el termjno: como fuessen su uja
% Quando assalir oujeron: fizo vna nemjga
En logar de uigilia: yogo con su amjga
Non fizo penjtençia: commo la ley predica
Metiosse al camjno: con su mala hortiga
...
% Dixoli sanctiago: don traydor parlero
Non uos puede uuestra parla: ualer vn mal dinero
Trayendo la mj uoz: como falso uozero
Diste conseio malo: mateste amj romero
% Sy tu no li dixieras: que santiago eras
Tu no li demostraras: sennal de mjs ueneras
Non dannara su cuerpo: con sus mjsmas tiseras
Nin yazria como yaze: fuera por las carreras
% Resçibi muy grant soberuja: dela uuestra partida
Tengo que la mj forma: es de uos escarnjda
Matastes mj romero: con mentira sabida
De mas ueo agora: el alma mal trayda
% Seet me a Juyzio: dela uirgo maria
Yo a ella me clamo: enesta pleytesia
Otra gujsa deues: yo non me qujtaria
Ca ueo que traedes muy grant aleuosia
% Propusieron sus uozes: delante la gloriosa
Ffue bien de cada parte: recapdada la cosa
Entendio las razones: la reyna preçiosa
Termjno la baraia: de materia sabrosa
% El enganno que tomo: pro li deuia tener
Elli a santiago: cuydo obedesçer
Ca tenja que por esso: saluo deuja seer
Mas el engannador: lo deuja padesçer
% Dixo yo esto mando: e do lo por sentençia
La alma sobre quien: auedes la entençia
Que torne enel cuerpo: faga su penjtençia
Despues. qual meresçiere: aura tal audiencia
% Salio esta sentençia: fue de dios otorgada
Ffue la alma mezqujna: enel cuerpo tornada
Que peso al diablo: e atoda su mesnada
A tornar fue la alma: ala ujeia posada
% Leuantosse el cuerpo: que yazia trastornado
Alimpiaua su cara: gujralte el degollado
Estido vn ratiello: como desacordado
Commo omne que duerme: e despierta irado
% La plaga que oujera: dela degolladura
Abes paresçia della: la sobre sanadura
Perdio la dolor: e toda la cochura
Todos dizian. este omne: fue de buena uentura
% Era delo al todo: sano e meiorado
Ffuera vn filiello: que tenja trauessado
Mas lo dela natura: quanto que fue cortado
Noli crescio vn punto: finco ensu estado
% De todo era sano: todo bien encorado
Para uerter su agua: finco li el forado
Requjrio su repuesto: lo que traya trosado
Penso de ir su uja: alegre. e pagado
% Rendia gracias a dios: e a sancta maria
E al sancto apostol: do ua la romeria
Començo se de andar: fallo la conpannja
Aujan este mjraglo: por solaz cada dia
% Sono por conpostela: esta grant marabilla
Vinjan lo auer: todos los dela ujlla
Dizian esta tal cosa: deujamos escriujrla
Los que son de uenjr: plazra lis de oirla
% Quando fue ensu tierra: la carrera cunplida
E ujdieron la cosa: que auja conteçida
Tenjan grandes clamores: era la gente moujda
Por ueer esti lazaro: dado de muerte a ujda
% Metio ensu fazienda: esti romeo mjentes
Como lo quito dios: de malditos dientes
Desanparo el mundo: riqueza e parientes
Metiosse en grunnjego: ujstio pannos punjentes
% Don ugo omne bueno: de clunnjego abbat
Baron religioso: de muy grant sanctidat
Contaua este mjraglo: que cuntio en uerdat
Metiolo en escripto: fizo grant honestidat
% Giraldo fino en orden: ujda buena faziendo
Endichos y en fechos: al criador serujendo
Enbien perseuerando: del mal se repentiendo
El enemjgo malo: non se fue del ridiendo
De quanto que peccara: dio a dios buen emjendo
ERa un simple preste: pobre de clerizia
Dizia cada dia: mjssa de sancta maria
Non sauja dezir otra: dizia la cadal dia
Mas la sauja por uso: que por saujduria
% Ffue este mjssacantano: al obispo acusado
Que era idiota: mal clerigo prouado
Salue sancta parens solo: tenja bien usado
Non sabia otra mjssa: el torpe enbargado
% Ffue dura mente moujdo: el obispo a sanna
Dizia nunca de preste: oy tal fazanna
Dixo. dezit al fijo: de la mala putanna
Que uenga ante mj: nolo ponga por manna
% Vino antel obispo: el preste peccador
Auja enel. grant mjedo: perdida la color
Non podia de uerguença: catar contral sennor
Nunca fue el mezquino: entan mala sudor
% Dixo li el obispo: preste dime uerdat
Sy es tal como dizen: la tu nesçiadat
Dixoli el buen omne: sennor por caridat
Sy dixiesse que non: non diria uerdat
% Dixoli el obispo: quando no as sçiençia
De cantar otra mjssa: no as seso nj potençia
Viedote que non cantes: pongo te ensentençia
Viuj como mereçes: por otra agudençia
% Ffue el preste su uja: triste e desarrado
Auja grant uerguença: e el danno muy granado
Torno enla gloriosa: lloroso e quexado
Queli diesse conseio: ca era aterrado
% La madre piadosa: que nunca fallesçio
Ca de coraçon: apiedes li cayo
El ruego del su clerigo: luego gelo oyo
Non lo puso por plazo: luego li acorrio
% La uirgo piadosa: madre sin polluçion
Apparesçiol al obispo: luego en ujsion
Dixoli fuertes dichos: un brauo sermon
Descubrioli en ello: todo su coraçon
% Dixoli braua mente: don obispo loçano
Contra mj por que fujste: tan fuerte. e tan ujllano
Yo nunca te qujte: ualia de vn grano
E tu as me quitado: amj vn capellano
% El que amj cantaua: la mjssa cada dia
Tu entendisti que fazia: yerro de eregia
Juzguestilo por bestia: e por cosa radia
Qujtestili la orden: dela capellanja
% Sy tu no li mandares: dezir la mjssa mja
Como solia dezirla: grant querella abria
Et tu seras finado: fasta el trenteno dia
Despues ueras que uale: la sanna de maria
% Ffue con estas menazas: el obispo espantado
Mando enbiar luego: por el preste uedado
Rogole quele perdonasse: lo que auja errado
Ca en el su pleyto fue: dura mente engannado
% Mandoli que cantasse: como solia cantar
Ffuesse dela gloriosa: sieruo desu altar
Sy algo li menguasse: o uestir. o calçar
El gelo mandaria: delo suyo mjsmo dar
% Torno el omne bueno: en su capellanja
Siruio ala gloriosa: madre sancta maria
Ffino en su offiçio: de fin qual yo querria
Ffue la alma agloria: ala dulçe confradia
% Non podemos nos tanto: escriujr njn rezar
Aun por que podiessemos : muchos annos durar
Que los diezmos mjraglos: podiessemos contar
Los que por la gloriosa: qujere dios demostrar
EN la villa de roma: essa noble çiudat
Maestra e sennora: de toda xristiandat
Auja y dos ermanos: de grant auctoridat
El vno era clerigo: el otro podestat
% Pedro dizian al clerigo: auja nonbre atal
Baron sabio e noble: del papa cardenal
Entre las otras mannas: auja vna sin sal
Auia grant auariçia: vn peccado mortal
% Esteuan auja nonbre: el segundo ermano
Entre los senadores: non auja mas loçano
Era muy poderoso: en el pueblo romano
Auja en prendo prendis: bien vsada la mano
% Era mucho cobdiçioso: queria mucho prender
Ffalsaua los Juyzios: por gana de auer
Qujtaualis alos omnes: lo que podia toller
Mas preciaua dineros: que Justiçia tener
% Con sus Juyzios falsos: delos sus paladares
A sant laurente el martir: quitoli tres solares
Perdio santa agnes: por elli bonos logares
Vn huerto que ualia: de sueldos muchos pares
% Murio el cardenal: don pedro el honrrado
Ffue alos purgatorios: do merescia seer leuado
Ante de pocos dias: fue esteuan finado
Atendia tal Juyzio: qual el lo auja dado
% Violo sant laurençio: catolo fea mente
Primjolo enel braço: tres uezes dura mente
Quexosse don esteuan: bien dentro enel ujentre
Nol apretaran tanto tenazas: de fierro mas fuerte
% Viol sancta agnes: aquien quito el huerto
Tornoli las espaldas: catol con rostro tuerto
Estonçe dixo esteuan: esto es mal confuerto
Toda nuestra ganançia: salio nos a mal puerto
% Dios el nuestro sennor: alcalde derechero
Al que non se encubre: bodega njn çellero
Dixo que esti omne: fuera mal ballestero
Cego a muchos omnes: non a vno sennero
% Deseredo a muchos: por mala uozeria
Siempre por sus peccados: asmo aleuosia
Non meresçe entrar: en nuestra conpannja
Vaya yazer con Judas: en essa enfermeria
% Tomaronlo por tienllas: los guerreros antigos
Los que siempre nos fueron: mortales enemjgos
Dauan li por pitança: non maçanas njn figos
Mas fumo e binagre: feridas e pelçigos
% Vio asu ermano: con otros peccadores
Do estaua el mezquino: en muy malos sudores
Daua uozes e gritos: lagrimas e plangores
Auia grant habundançia: de malos serujdores
% Dixol dezit ermano: preguntar uos lo quiero
Por qual culpa yazedes: en lazerio tan fjero
Ca sy dios lo quisiere: e yo fazer lo pudiero
Buscar uos he acorro: en quanto que sopiero
% Aujan la ya leuada: açerca dela posada
Do nunca ueria cosa: de que fuesse pagada
Nin ueria sol njn luna: njn buena ruçiada
E seria entinjebra: como enparedada
% Dixo pedro. en ujda traxi: grant auariçia
Oujla por amjga: abueltas con cobdiçia
Por esso so agora: puesto ental tristiçia
Quj tal faze. tal prenda: fuero es e iustiçia
% Mas si el apostolico: con la su clerizia
Cantasse por mj mjssa: sola mente vn dia
Ffio enla gloriosa: madre sancta maria
Que me daria dios luego: alguna meioria
% E este baron don esteuan: de qui fablamos tanto
Por que muchas maldades: traya so el su manto
Auia vna bondat: amaua aun sancto
Tanto que non podriamos: demostrar uos nos quanto
% Amaua a proiecto: martir de grant ualor
Aguardaual bien la fiesta: como a buen sennor
Ffazial rico offiçio: e muy grant honor
De pobres. e de clerigos: quanto podia meior
% Laurençio e agnes: pero que despechados
Por que los ouo el: ante deseredados
Moujolos piadat: e fueron amansados
Cataron mas a dios: que alos sus peccados
% Ffueron para proiecto: fuera cuyo rendido
Dixieronli proiecto: non seas adormjdo
Piensa del tu esteuan: que anda escarnjdo
Rendeli galardon: ca ouo te serujdo
% Ffue para la gloriosa: que luze mas que estrella
Moujola con grant ruego: fue ante dios con ella
Rogo por esta alma: que trayan como a pella
Que non fuesse Juzgada: segunt la querella
% Dixo aeste ruego: dios el nuestro sennor
Ffare tanta de gracia: por el uuestro amor
Torne aun al cuerpo: la alma peccador
Despues. qual mereçiere: reçibra tal honor
% Aya tanto de plazo: fasta los treynta dias
Que pueda meiorar: todas sus malfetrias
Mas bien gelo afirmo: por las palabras mjas
Y seran rematadas: todas sus maestrias
% Rendieron gracias muchas: a dios los rogadores
Por que enpiadaua: alos sus peccadores
Que libro esta alma: de mano de traydores
Que son delos fieles: siempre engannadores
% Quando lo entendio: la gente adiablada
Quitaron se del alma: que tenjan ligada
Tomola sant proiecto: que la auja ganada
Gujola para el cuerpo: a essa su posada
% Dixo li la gloriosa: madre del criador
Esteuan. rendi gracias: a dios el buen sennor
Grant gracia te a fecha: que non podria mayor
Del mal si non te guardas: caeras en peor
% Esteuan vn conseio: te quiero avn dar
Esteuan este conseio: que deues tu tomar
Mandote cada dia: vn salmo reçitar
Beati in maculati: bien bueno de usar
% Sy tu cada mannana: este psalmo rezares
E tu alas iglesias: el tuerto emendares
Ganara la tu alma: gloria quando finares
Escusaras las penas: e los graues logares
% Resusçito esteuan: grado a ihesu xpisto
Lo queli dixo pedro: su ermano bien quisto
Recontogelo al papa: quanto que auja ujsto
Que yazia en grant pena: lazrado. e muy tristo
% Demostraua el braço: que tenja liborado
Enel que sant laurent: lo ouo apretado
Pidia merçed al papa: con el cuerpo prostrado
Que cantasse la mjssa: por pedro el lazrado
% Por fer les bien creençia: por seer bien creydo
Dixo que alos treynta dias: seria transido
Dixieron todos esto: signo es conosçido
Sy dize uerdat o non: sera bien entendido
% Entergo rica mente: alos deseredados
A los que tuerto touo: fizo los bien pagados
Confessosse al preste: de todos sus peccados
De quantos auja fechos: e dichos. e asmados
% Ya andaua en cabo: delas quatro semanas
Ffasta los treynta dias: auja pocas mannanas
Despidiosse esteuan: delas gentes romanas
Sabia quelas palabras: de dios. non serian uanas
% Enel dia trenteno: fizo su confession
Resçibio corpus dominj: con grant deuoçion
Echosse en su lecho: fizo su oraçion
Rendio a dios la alma: fino con bendiçion
ERa en vna tierra: vn omne labrador
Que usaua la reia: mas que otra lauor
Mas amaua la tierra: que non al criador
Era de muchas guysas: omne reboluedor
% Ffazia vna nemjga: suzihuela por uerdat
Cauaua los moiones: por ganar heredat
Ffazia atodas gujsas: tuerto e falsedat
Auja mala fama: entre su uezindat
% Queria pero que malo: bien asancta maria
Oya los sus mjraglos: daualis a cogia
Saludauala siempre: diziali cada dia
Aue graçia plena: que pariste amessia
% Ffino el rastra paia: de tierra bien cargado
En soga de diablos: fue luego captiuado
Rastrabanlo por tiemplas: de coçes bien souado
Pechauanli al doble: el pan que dio mudado
% Dolieron se los angeles: desta alma mezquina
Por quanto la leuauan: diablos en rapina
qujsieron acorrerle: ganarla por uezina
Mas para fazer tal pasta: menguabalis farina
% Sy lis dizian los angeles: de bien vna razon
Ciento dizian los otros: malas ca buenas non
Los malos alos buenos: tenjan los en rencon
La alma por sus peccados: non salia de presion
% Leuantosse vn angel: dixo. yo so testigo
Verdat es non mentira: esto que yo uos digo
El cuerpo el que traxo: esta alma consigo
Ffue de sancta maria: uassallo e amjgo
% Siempre la ementaua: a yantar e a çena
Diziali tres palabras: aue graçia plena
La boca por que salia: tan sancta cantilena
Non meresçia yazer: en tan mala cadena
% Luego que esti nonbre: dela sancta reygna
Oyeron los diablos: cogieron se de y ayna
Derramaron se todos: como vna neblina
Desanpararon todos: ala alma mezquina
% Vieron la los angeles: seer desemparada
De piedes e de manos: de sogas bien trauada
Estaua como oueia: que yaze ensarçada
Ffueron. e traxieron la: para la su maiada
% Nonbre tan auenturado: e de uirtut tanta
Que alos enemjgos: seguda. e espanta
Non nos deue doler: njn lengua njn garganta
Que non digamos siempre: salue regina sancta
EN vna ujlla buena: que la llaman pauja
Ciudat de grant fazienda: yaze en lonbardia
Auja dentro en ella: rica buena mongia
De muy buenos omnes: muy sancta conpannja
% Era el monesterio: alçado en honor
Del que saluo el mundo: sennor sant saluador
Auia por auentura: en elli vn prior
Que non queria ueujr: sy non asu sauor
% Auja el omne bueno: vna lengua errada
Dezia mucha orrura: dela regla uedada
Ffazia vna tal ujda: non mucho ordenada
Pero dizia sus horas: en manera temprada
% Auja vna costunbre: que li fizo prouecho
Dizia todas sus horas: como monge derecho
A las dela gloriosa: siempre estaua arecho
Aujali el diablo por ello grant despecho
% Pero que semeiaua: en vnas cosas boto
En amar la gloriosa: era muy deuoto
E como uos dixiemos: que era boca roto
Dizia el su offiçio: de suo corde toto
% Ouo quando dios quiso: este prior afinar
Cayo en vn exilio: en aspero logar
Non uos podria nul omne: el lazerio contar
Que el prior leuaua: njn lo podria asmar
% Auja vn sacristano: en essa abbadia
Que guardaua las cosas: dela sacristanja
Huberto auja nonbre: cuerdo. e sin folia
Valia mas ca non menos: por elli la mongia
% Ante delos matines: vna grant madrugada
Leuantosse este monge: rezar la matinada
Tanner alos matines: despertar la mesnada
Enderezar las lampadas: alumbrar la posada
% El prior dela casa: de suso ementado
Anno auia cumplido: de que fuera passado
Pero fue el su pleyto: en cabo rezentado
Tan bien como al dia: quando fue soterrado
% El monge dela casa: que sacristano era
Ante que enpeçasse: tanner la monedera
Alimpiaua las lampadas: por fer meior lunbrera
Tomo vn grant espanto: de estranna manera
% Oyo una uoz de onbre: flaqujella e cansada
Dixo. frayre uberto: sola una uegada
Conosciola ubert: e non dubdo en nada
Que la del prior era: tomo grant espantada
% Salio dela iglesia: fue ala enfermeria
Non leuaua de mjedo: la uoluntat uazia
Non iria tan aprisa: yendo en romeria
Don ujldur lo leuaua: par la cabeça mja
% Estando de tal gujsa: fuera delas uirtudes
Oyo. ubert ubert: por que me non recudes
Cata non ayas mjedo: por ren non te demudes
Piensa como me fables: e como me pescudes
% Estonze dixo unbert: prior fe que deuedes
De uos como estades: uos non melo neguedes
Que sepa el cabildo: de uos como seedes
En qual estado sodes: o qual lo attendedes
% Dixo el prior: ubert el mjo criado
Sepas fasta aquj: mala de mj estado
Cadi en vn exilio: crudo e destenprado
El principe dela tierra: smjrna era llamado
% Suffri mucho lazerio: passe mucho mal dia
El mal que e passado: contar nolo podria
Mas ouo a passar: por y sancta maria
Ouo pesar e duelo: del mal que yo suffria
% Tomo me por la mano: e leuo me consigo
Leuo me alogar: temprado e abrigo
Qujto me dela premja: del mortal enemjgo
Puso me en logar: do ujbre syn peligro
% Grado ala gloriosa: que es de gracia plena
Cay en dulçe uergel: çerca de dulçe colmena
Ffuera so del lazerio: e salido so de pena
Do nunca uere mengua: de yantar njn de çena
% Callo la uoz con tanto: desperto el conuento
Ffueron ala iglesia: todos de buen taliento
Dixieron los matines: fizieron cunplimjento
De gujsa que podria: dios auer pagamjento
% Los matines rezados: esclaresçio el dia
Dixieron luego prima: despues. la ledanja
Ffueron asu cabildo: la sancta conpannja
Ca esto es de regla: costunbre de mongia
% Estando en cabildo: leyda la lection
Ffizo el sacristano: su genu+flexion
Contolis al conuento: toda la ujsion
Plorando delos oios: amuy grant mjssion
% Rendieron todos gracias: ala madre gloriosa
Que sobre sus uassallos: es siempre piadosa
Ffueron ala iglesia: cantando rica prosa
Ffizieron en escripto: poner toda la cosa
% Onde apoco tiempo: murio el sacristano
Murio de fin qual done dios: atodo xpistiano
Salio de mal ybierno: entro en buen uerano
Ffue para parayso: do sera siempre sano
% Esto es sumum bonum: de seruir a tal sennora
Que saue asus sieruos: acorrer ental hora
Esta es buena tienda: esta buena pastura
Que uale a todo omne: que de buen cuer la hora
% Quantos quela ujeron: esta tal ujsion
Cogieron ensus almas: mayor deuoçion
En ornar la gloriosa: de meior coraçon
Aclamarse a ella: en su tribulaçion
% En essa çiudat mjsma: auia vn buen xpistiano
Auia nonbre iheronjmo: era mjssa+cantano
Ffazia ala gloriosa: seruiçio muy cutiano
Los dias. e las noches: yujerno. y uerano
% Ffino por auentura: el obispo del logar
Non se podian por nada: en otro acordar
Toujeron triduano: querian a dios rogar
Que elli lis mostrasse: qual deujessen alçar
% A un omne catolico: bien de religion
Ffabloli la gloriosa: dixol en ujsion
Baron por que estades: en tal dissension
Dat al mj creendero: esta election
% Dixol el omne bueno: por seer mas çertero
Quj eres tu qui fablas: o qui el creendero
Yo so dixoli ella: la madre de dios uero
Jheronjmo li dizen: a essi mjo clauero
% Sey mj messagero: lieua esti mandado
Yo te mando que sea: ayna recapdado
Sy al faze el cabildo: sera mal engannado
Non sera el mj fijo: del su fecho pagado
% Dixo lo e creyeron lo esto: los electores
Mas quj era iheronjmo: non eran sabidores
Metieron por la ujlla: omnes baruntadores
Darian buena alujzra: alos demostradores
% Trouaron a geronjmo: preste parrochial
Omne sin grandes nueuas: que sauja poco mal
Leuaronlo por mano: ala siella cathedral
Dieronli por pitança: la siella obispal
% Siguiendo el messaie: el de sancta maria
Ffizieron lo obispo: e sennor de pauja
Oujeron ende todos: sauor e alegria
Que uedian quela cosa: ujnja por buena uja
% Ffue muy buen obispo: e pastor derechero
Leon para los brauos: alos mansos cordero
Guiaua bien su grey: non como soldadero
Mas como pastor firme: que esta bien fazero
% Guioli su fazienda: dios nuestro sennor
Ffizo buena la ujda: la fin muy meior
Quando salio deste mundo: fue al otro mayor
Guiolo la gloriosa: madre del criador
% Madre tan piadosa: siempre sea laudada
Siempre sea bendicha: e siempre adorada
Que pone sus amigos: en honrra tan granada
La su mjsericordia: nunca seria asmada
SAnt migel: dela tumba: es vn grant monesterio
El mar lo çerca todo: elli yaze en medio
En logar peligroso: do suffren grant lazerio
Los monges que y ujujan: en essi çimjterio
% Enesti monesterio: que auemos nonbrado
Auia de buenos monges: buen conuento prouado
Altar dela gloriosa: rico. e muy honrado
En el rica ymagen: de preçio muy granado
% Estaua la ymagen: en su trono posada
Su fijo en sus braços: cosa es costunbrada
Los reys redor de ella: estaua bien conpannada
Como rica reyna: de dios sanctificada
% Tenja rica corona: como rica reyna
De suso vna Jmpla: en logar de cortina
Era bien entallada: de lauor muy fina
Valia mas essi pueblo: que la auja uezina
% Colgaua delante ella: vn buen auentadero
Enel seglar lenguaie: dizienli moscadero
De alas de pagones: lo fizo el obrero
Luzia como estrellas: semeiante del luzero
% Cayo rayo del çielo: por los graues peccados
Ençendio la iglesia: de todos quatro cabos
Quemo todos los libros: e los pannos sagrados
Por poco fue los monges: que non fueron quemados
% Ardieron los armarios: e todos los frontales
Ardieron las ampollas: caliçes e çiriales
Las uigas las gateras: los cabrios los cunbrales
Suffrio dios essa cosa: como faze otros tales
% Maguer que fue el fuego: tan fuerte e tan quemante
Nin llego ala duenna: njn llego al Jnfante
Nin llego al flabello: que colgaua delante
Nili fizo de danno: vn dinero pesante
% Ni ardio la ymagen: nj ardio el flabello
Nin tomaron de danno: quanto uale vn cabello
Sola mente el fumo: non se lego a ello
Nil nuzio mas que nuzo: yo al obispo don tello
% Continens est çençentum: fue todo astragado
Torno todo carbones: fue todo assolado
Mas redor la ymagen: quanto es un estado
Non fizo mal el fuego: ca non era osado
% Esto toujeron todos: por fiera maraujlla
Que njn fuego njn fumo: non se lego aella
Que estaua e flabello: mas claro que estrella
El njnno muy fermoso: fermosa la ponzella
% El preçioso mjraglo: non cayo en olbido
Ffue luego bien dictado: en escripto metido
Mientre el mundo sea: sera al retraydo
Algun malo por ello: fue abien conuertido
% La uirgo benedicta: reyna general
Como libro su toca: de esti fuego tal
Assy libra sus sieruos: del fuego perennal
Lieua los ala gloria: do nunca uean mal
Enla çibdat de pisa: çipdat bien capdelera
En puerto de mar yaze: rica de grant manera
Auia y un calonge: de buena alcauera
Dizian sant cassian: donde el calonge era
% Como fizieron otros: que de suso contamos
Que de sancta maria: fueron sus capellanos
Esti amola mucho: mas que muchos xristianos
E faziali serujçio: de piedes e de manos
% Non auja essy tiempo: uso la clerizia
Dezir njngunas horas: ati uirgo maria
Pero elli dizialas: siempre e cada dia
Auia ende la gloriosa: sauor e alegria
% Auian los sus parientes: este fijo sennero
Quando ellos finassen: era buen heredero
Ca tenja buen casamjento: assaz copdiçiadero
Dexauan li de mueble: assaz rico çellero
% El padre e la madre: quando fueron finados
Vynjeron los parientes: tristes. e desarrados
Dizianli que fiziessen: algunos engendrados
Que non fincassen yermos: logares tan preçiados
% Canbiosse del proposito: del que ante tenja
Moujolo la ley del mundo: dixo que lo faria
Buscaron li esposa: qual ael conuenja
Destaiaron el dia: que las bodas faria
% Quando ujno el dia: delas bodas correr
Yua con sus parientes: la esposa prender
Tan bien enla gloriosa: non podia entender
Como lo solia ante: otro tiempo fazer
% Yendo por la carrera: acomplir su depuerto
Menbrol dela gloriosa: queli yazia en tuerto
Touosse por errado: e touose por muerto
Asmo bien esta cosa: quel saldria a mal puerto
% Asmo esta cosa: de coraçon cambiado
Ffallo vna iglesia: logar a dios sagrado
Dexo las otras gentes: fuera del portegado
Entro fazer oracion: el noujo refrescado
% Entro enla iglesia: al cabero rencon
Jnclino sus ynoios: fazia su oraçion
Vino la gloriosa: llena de bendiçion
Como que sannosa mente: dixo la razon
% Don loco malauenturado: torpe enloqueçido
En que roydos andas: en que eres caydo
Semeias erbolado: que as yerbas beujdo
O que eres del blago: de sant martin ferido
% Assaz eras baron: bien casado amjgo
Yo mucho te queria: como a buen amjgo
Mas tu andas buscando: meior de pan de trigo
Non baldras mas por esso: quanto uale vn figo
% Sy tu amj quisieres: escuchar. e creer
Dela ujda primera: non te quieras toller
A mj non dexaras: por con otra tener
Sy non. abras la lenna: acuestas atraer
% Salio dela iglesia: el noujo maestrado
Todos aujan querella: que auja detardado
Ffueron cabo adelante: recabdar su mandado
Ffue todo el negoçio: ayna recapdado
% Ffizieron ricas bodas: la esposa ganada
Ca seria lo al fonta: sy fuesse desdennada
Era con este noujo: la nouja bien pagada
Mas non entendia ella: do yazia la çelada
% Sopo bien encobrirse: el sesudo baron
La lengua poridat: touo al coraçon
Redia e de+portaua: todo bien a razon
Mas aujalo cambiado: mucho la ujsion
% Ouieron ricas bodas: e muy grant alegria
Nunca mayor siquiera: oujeron en vn dia
Mas echo la red magna: por y sancta maria
E fizo en sequero: vna grant pesqueria
% Quando ujno la noche: la hora que durmjessen
Ffizieron alos noujos: lecho en que durmjessen
Ante que entre sy: njngun solaz oujessen
Los braços dela nouja: non tenjan que prisiessen
% Salioseli de manos: fuyoseli el marido
Nunca sauer podieron: omnes do fue caydo
Sopolo la gloriosa: tener bien ascondido
Nolo consintio ella: que fuesse corrompido
% Dexo muger fermosa: e muy grant possession
Lo que farian bien pocos: delos que oy son
Nunca lo entendieron: do cayo. o do non
Quj por dios tanto faze: aya su bendiçion
% Creemos. e asmamos: que esti buen baron
Busco algun buen logar: de grant religion
Ende estouo escondido: faziendo oraçion
Poronde gano la alma: de dios buen gualardon
% Bien deuemos creer: que la madre gloriosa
Por quj fizo este omne: esta tan manna cosa
Nonlo olbidaria: como es piadosa
Bien alla lo faria: posar do ella posa
EN la ujlla de borges: vna ciudat estranna
Cuntio en essi tiempo: vna buena fazanna
Sonada es en françia: sy faze en alemanna
Bien es delos mjraglos: semeiante e calanna
% Vn monge la escriujo: omne bien uerdadero
De sant migael era: dela clusa claustero
Era en essy tiempo: vn burges hostalero
Pedro era su nonbre: fue ende bien çertero
% Tenja en essa ujlla: ca era menester
Vn clerigo escuela: de cantar e leer
Tenja muchos criados: a letras aprender
Ffijos de buenos omnes: que querian mas ualer
% Vinja vn Judezno: natural del logar
Por sauor delos njnnos: por con ellos iogar
Acogian lo los otros: noli fazian pesar
Aujan con el todos: sauor de deportar
% Enel dia de pascua: domjngo grant mannana
Quando uan corpus dominj: prender la gente xristiana
Tomole al Judezno: de comulgar grant gana
Comulgo con los otros: el cordero sin lana
% Mientre que comulgauan: a muy grant pressura
El njnno Judezno: alço la catadura
Vio sobre el altar: vna bella figura
Vna fermosa duenna: con genta creatura
% Vio que esta duenna: que posada estaua
A grandes e a chicos: ella los comulgaua
Pagosse della mucho: quanto mas la cataua
Dela su fermosura: mas se enamoraua
% Salio dela iglesia: alegre e pagado
Ffue luego asu casa: como era uezado
Menazoli el padre: por que auja tardado
Que meresçiente era: de seer fostigado
% Padre dixo el njnno: non uos negare nada
Que con los xristianjllos: fuy grant madrugada
Con ellos oy mjssa: rica mente cantada
E comulge con ellos: dela hostia sagrada
% Pesoli esto mucho: al mal auenturado
Como si lo toujessen: muerto o degollado
Non sauja con ira: que fer el en+diablado
Ffazia figuras malas: como demonjado
...
Tres caualleros: eran de vna atenençia
Con otro su uezino: aujan grant mala querençia
Matarian lo de grado: sy oujessen potençia
En buscarli muerte mala: ponjan toda femençia
% Tanto podieron: ellos reuolber e buscar
Oujeron lo vn dia: solo abarruntar
Echaron li çelada: ca querian lo matar
Mas lo querian tener: que grant auer ganar
% Entendiolos el otro: quelo querian matar
Non se oso por nada: con ellos. a en+campar
Enpeço a foyr: ca queria escapar
Moujeron luego ellos: fueron lo en calzar
% El que yua fuyendo: con muy grant pauor
Ffallo vna iglesia: ouo ende grant sauor
Era dela gloriosa: fecha ensu honor
Escondiosse en ella: mezquino peccador
% Los que lo segujan: que lo querian matar
Non oujeron uerguença: del sagrado logar
Qujsolo la gloriosa: e dios desemparar
Oujeron li la alma: del cuerpo a sacar
% Dentro enla iglesia: dela uirgo sagrada
Y fue esta persona: muerta e liuorada
Touosse la gloriosa: mucho por affontada
Los quj la affontaron: non ganaron y nada
% La reyna de gloria: touo se por prendiada
Por que la su iglesia: fincaua ujolada
Pesol de coraçon: fue ende despechada
Demostrogelo luego: que les era yrada
% Enbio dios en ellos: vn fuego enfernal
Non ardia e quemaua: como el de sant marçal
Quemaualis mjenbros: de manera mortal
Dizian a grandes uozes: sancta maria ual
% Con esta maiadura: eran muy mal trechos
Perdian pies e manos: e fincauan contrechos
Las piernas e los braços: bien çerca delos pechos
Yua sancta maria: prendiendo sus derechos
% Peorauan cada dia: amuy grant poder
Tomaron vn conseio: ante fuera aprender
Tornar enla gloriosa: que los fazia arder
Los sanctos njn las sanctas: non los querian ualer
% Entendian los pueblos: ellos nolo negauan
Que ellos meresçieron: por donde tanto lazrauan
Las uirtudes sannosas: que ellas los matauan
Nolo asmauan ellos: quando las ujolauan
% Cadieron li apreçes: delante el su altar
Plorando delos oios: quanto podian llorar
Dizian madre gloriosa: denna nos perdonar
Ca non fallamos otro: que nos pueda prestar
% Sy nos mal mereçiemos: rica mente lo lazramos
Vien nos uerna emjente: mjentre ujuos seamos
Madre sy nos perdonas: bien te lo otorgamos
Que enla tu iglesia: nunca fuerça fagamos
% Madre repisos somos: del yerro que fiziemos
Erramos dura mente: grant locura traxiemos
Resçibiemos grant quebranto: mayor lo meresçiemos
Pechado lo auemos: el escote que comjemos
% Madre sy nos no uales: de ti no nos partremos
Sy tu no nos perdonas: de aquj no yremos
Sy tu no nos acorres: a nada nos tenemos
Syn ti. desta fiebre: termjnar non podemos
% La madre gloriosa: solaz delos cuytados
Non desdenno los gemjdos: delos omnes lazrados
Non cato asus meritos: nj alos sus peccados
Mas cato asu mesura: ualio alos quemados
% La duenna piadosa: que fue ante yrada
Ffue perdiendo la ira: e fue mas amansada
Perdonolis la sanna: quelis tenja alçada
Toda la malatia: fue luego abadada
% Amansaron los fuegos: quelos fazian arder
Aujan mayor remedio: que non solian auer
Sintian que la gloriosa: pro lis queria tener
Plorauan con grant gozo: non se sabian que fer
% Amansaron los fuegos: perdieron los dolores
Mas nunca delos mjenbros: non fueron bien sennores
Siempre fueron contrechos: siempre mendigadores
Siempre se aclamauan: por mucho peccadores
% Con esta meioria: que dios lis quiso dar
Ffueron luego al obispo: absoluçion ganar
Ffizieron confession: como la deujan far
Lorando delos oios: mostrando grant pesar
% Maestrolis el obispo: oyolis su confession
Entendio que uenjan: con buena contriçion
Diolis su penjtençia: e la absoluçion
Todo lo al passado: diolis su bendiçion
% Syn muchas romerias: que lis mando andar
Syn muchas oraciones: que lis mando rezar
Las armas con que fueron: la iglesia quebrantar
Mandogelas por siempre: asus cuestas leuar
% Estos penetençiales: quando fueron maestrados
E fueron absolujdos: de todos sus peccados
Departieron se luego: tristes e desarrados
Ffueron asendas partes: de sus armas cargados
% Asendas partes fueron: en vno non toujeron
Como es mj creençia: nunca mas se ujdieron
Nunca mas so vn techo: todos tres non yoguieron
Lo que mando el obispo: bien e gent lo cunplieron
% En fazer la maldat: fueron bien denodados
En fazer la penjtençia: fueron bien aspirados
Nolis dolian los mjenbros: andauan bien lazrados
Aujendo malas noches: e dias denegrados
% Sy en fazer el peccado: fueron çiegos e botos
Ffueron en emendarlo: firmes e muy deuotos
Quantos dias ujujeron: fueron muchos o pocos
Dieron sobre sus carnes: lazerios e corrotos
% De todos tres el vno: flaco e muy lazrado
Vino en anfridi: commo dize el dictado
Albergo enla ujlla: dieron li ospedado
Con vna sancta fenbra: con que fue bien albergado
% Contolis asus huespedes: toda su auentura
Como enla iglesia: fizieron desmesura
Como sancta maria: ouo dellos rencura
E como se perdieron: de mala calentura
% Temjendo que su dicho: noli seria creydo
Delante muchos omnes: qujtose el uestido
Demostrolis vn fierro: que traya escondido
Cinto ala carona: correon bien desabrido
% Podria auer en ancho: quanto media palmada
Era çerca del fierro: la carne mal Jnchada
La que yazia de yuso: toda era quemada
Ffue ende otro dia: de buena madrugada
% Ffizieron se los omnes: todos maraujllados
Ca oyan fuertes dichos: uedian mjenbros dannados
Do qujer que se Juntauan: mançebos. o casados
De esso fablauan todos: mançebos e ançianos
% Ffue luego este mjraglo: escripto e notado
Por amor que non fuesse: el olbido echado
Cogieron muchos mjedo: de fazer tal peccado
De quebrantar iglesia: en logar consagrado
% Tal es sancta maria: qual entender podedes
A los que en mal andan: echalis malas reddes
Sobre los conuertidos: faze grandes merçedes
Muchos son los exiemplos: que desto trobaredes
% Tantos son los exiemplos: que non serian contados
Ca creçen cada dia: dizen lo los dictados
Estos con çiento tantos: diezmos serian echados
Ella ruege a xpisto: por los pueblos errados
EN toledo la noble: que es arçobispado
Vn dia de grant fiesta: por agosto mediado
Ffiesta dela gloriosa: madre del buen criado
Conteçio vn mjraglo: grande e muy sennalado
% Estaua el arçobispo: vn leal coronado
En medio dela mjssa: sobrel altar sagrado
Oyendola grant pueblo: pueblo bien adobado
La iglesia bien llena: el coro bien poblado
% Las gentes muy deuotas: estauan en oracion
Como omnes que quieren: ganar de dios perdon
Oyeron vnas uozes: de grant tribulaçion
Por onde fue perturbada: toda la proçession
% Ffablolis uoz del çielo: doliente e querellosa
Oyt dixo xpistianos: vna estranna cosa
La gente del Judaismo: sorda e çegaiosa
Nunca contra don xpisto: non fue mas porfidiosa
% Segun que uos dizen: las sanctas escripturas
Ffizieron en don xpisto: muy grandes trauessuras
Taiaua essa cuyta: amj las assaduras
Mas en ellos quebraron: todas las sus locuras
% Nin se dolian del fijo: que mal non mereçia
Nin dela madre suya: que tal cuyta uedia
Pueblo tan descosido: que tal mal comedia
Quj atal li fiziesse: nul tuerto nol faria
% Los que mala naçieron: falsos e traydores
Agora me renueuan: los antigos dolores
En grant priessa me tienen: e en malos sudores
En cruz esta mjo fijo: luz delos peccadores
% Otra uez crucifigan: al mj caro fijuelo
Non entendria nul omne: quan grande es el mj duelo
Criasse en toledo: vn amargo maJuelo
Non se crio tan malo: nunca enesti suelo
% Oyeron esta uoz: toda la clerizia
E muchos delos legos: dela mozarauja
Entendieron que era: uoz de sancta maria
Que fazian contra ella: los Judios follia
% Ffablo el arçobispo: que la mjssa cantaua
Escucholo el pueblo: que çerca li estaua
Creet dixo conçeio: que la uoz que fablaua
Resçibe grant soberuja: por ende se querellaua
% Sepades que Judios: fazen alguna cosa
En contra Jhesu xpisto: fijo dela gloriosa
Por essa cuyta anda: la madre querellosa
Non es esta querella: baldera nj mjntrosa
% Conuento e conçeio: quantos aquj seedes
Metet mjentes enesto: e nolo desdennedes
Sy la cosa buscardes: batuda fallaredes
De esta malfetria: derecho tomaredes
% Vayamos alas casas: esto nolo detardemos
Delos rabis mayores: ca algo fallaremos
Dexemos las yantares: ca bien las cobraremos
Sy non dela gloriosa: mal reptados seremos
% Moujeron se los pueblos: toda la clerizia
Ffueron amuy grant priessa: para la Juderia
Gujolos Jhesu xpisto: e la uirgo maria
Ffue luego descubierta: la su aleuosia
% Ffallaron enla casa: del rabi mas honrrado
Vn grant cuerpo de çera: como omne formado
Como ihesu xpisto estouo: estaua crucificado
Con grandes clauos preso: gran llaga al costado
% Quanta fonta fizieron: enel nuestro sennor
Alli la fazian toda: por nuestra desonor
Recabdaron los luego: mas non con grant sabor
Qual fazian tal resçibieron: grado al criador
% Ffueron bien recabdados: los que prender podieron
Dieron lis yantar mala: qual ellos merecieron
Y fizieron tu autem: mala muerte resçibieron
Despues lo entendian: que mal seso fizieron
% Quj asancta maria: qujsiere afontar
Como estos ganaron: assy deuen ganar
Mas pensemos la nos: de serujr e honrrar
Ca nos el su ruego: encabo a prestar
DE vn otro mjraglo: uos queremos fablar
Que cuntio otro tiempo: en vn puerto de mar
Estonze lo entendredes: e podedes Jurar
La uirtut de maria: que es en cada logar
% Entendredes en ello: como es la gloriosa
En mar e enterreno: por todo poderosa
Como uale ayna: ca non es perezosa
E nunca fallo omne: madre tan piadosa
% Çerca vna marisma: tumba era llamada
Ffaziasse vna ysla: cabo la orellada
Ffazia la mar por ella: sallida e entrada
Dos uezes enel dia: o tres ala uegada
% Bien dentro enla ysla: delas ondas çerquiella
De sant mjgel era: auja vna capiella
Cuntian grandes uirtudes: siempre en essa çiella
Mas era la entrada: non poco asperiella
% Quando queria el mar: contra fuera salir
Salia afiera priessa: non se sabia soffrir
Omne maguer ligero: noli podria foyr
Sy ante non saliesse: y auria aperir
% El dia dela fiesta: del archangel preçioso
Era el mar mas quedo: yazia mas spaçioso
Oya el pueblo mjssa: non ason uagaroso
Ffuyan luego asaluo: a corso presuroso
% Vn dia por uentura: conla otra mesnada
Metiosse vna fembra: flaquiella e prennada
Non podio acordarse: tan bien ala tornada
Touosse por repissa: por que era entrada
% Las ondas uenjan çerca: las gentes alongadas
Auja con el desarro: las piernas enbargadas
Las conpannas non eran: de ualerli osadas
En poquiello de termjno: auja muchas iornadas
% Quando al non podian: las gentes con ardura
Valas sancta maria: dizian agrant pressura
La prennada mezquina: cargada de rencura
Ffinco entre las ondas: en fiera angostura
% Los que eran salidos: commo non uedian nada
Cuydauan syn dubda: que era enfogada
Dizian esta mezquina: fue desauenturada
Sus peccados toujeron li: vna mala çelada
% Ellos esto diziendo: encogiosse la mar
En poco de ratiello: torno ensu logar
Qujsolis grant mjraglo: don xpisto demostrar
Por onde la su madre: oujessen que fablar
% Ellos que se querian todos: yr su carrera
Estendieron los oios: cataron ala glera
Vydieron que uenja: vna muger sennera
Con su fijo enbraços: en contra la ribera
% Ffizieron se las gentes: todas marabilladas
Tenjan que fantasia: las auja engannadas
Pero apoca dora: fueron çertificadas
Rendian gracias a xpisto: todos manos alçadas
% Dixieron. dezit duenna: por dios e caridat
Por dios uos conJuramos: dezit nos la uerdat
Dezit nos dela cosa: toda çertenjdat
E como uos librastes: de uuestra prennadat
% Por dios aujno esto: en ello non dubdamos
Et por sancta maria: ala que nos rogamos
E por sant mjgel: en cuya uoz andamos
Esti tal mjraglo: bien es que lo escriuamos
% Oyt dixo la duenna: la mj buena conpanna
Creo que non ujdiestes: nunca mayor fazanna
Sera bien retrayda: por la tierra estranna
En greçia e en françia: e por toda espanna
% Quando ujdi que de muerte: estorçer non podia
Que de las ondas fieras: circumdada sedia
Comendeme a xpisto: e a sancta maria
Ca por mj conseio: otro non entendia
% Yo en esto estando: ujno sancta maria
Cubrio me conla manga: dela su almexia
Non senti nul peligro: mas que quando dormja
Sy yoguiesse en banno: mas leda non seria
% Syn cuita e sin pena: sin ninguna dolor
Pari este fijuelo: grado al criador
Ouj buena madrina: non podria meior
Ffizo mjsericordia: sobre mj peccador
% Ffizo en mj grant gracia: non vna ca doblada
Valiome enel parto: que seria dannada
Nunca muger non ouo: madrina tan honrada
Sy por ella non fuesse: seria enfogada
% Assy fue mj fazienda: como yo uos predigo
Ffizo sancta maria: grant piadat comjgo
Onde todos deuemos: prender ende castigo
Rogar le que nos libre: del mortal enemjgo
% Oujeron del mjraglo: todos grant alegria
Rendieron a dios gracias: e a sancta maria
Ffizieron vn buen cantico: toda la confradia
Podrialo enla iglesia: cantar la clerezia
% Xpisto sennor e padre: del mundo redemptor
Que por saluar el pueblo: soffriste muerte e dolor
Tu seas benedicto: que eres buen sennor
Nunca te toma asco: de omne peccador
% Tu libreste a ionas: del ujentre del pescado
Que lo touo tres dias: ensu bientre çerrado
Non tomo lesion: ca fue de ti guardado
El mjraglo ujeio: oy es renouado
% Ffijos de israel: quando la mar passaron
Que por tu mandamjento: tras moyses gujaron
Yaziendo solas ondas: nul danno non tomaron
Mas los persecutores: todos se enfogaron
% Los antigos mjraglos: preçiosos e honrados
Por oio los ueemos: agora renouados
Sennor los tus amjgos: enel mar fallan uados
A los otros en seco: los fallan enfogados
% Sennor la tu potençia: grande e maraujllosa
Esa saluo a sant pedro: enla mar peligrosa
Sennor que encarneste: enla uirgo gloriosa
En ti solo fiamos: ca non en otra cosa
% Sennor bendicha sea: la tu uirtut sagrada
Bendicha la tu madre: reygna coronada
Tu seas bendicho: ella sea laudada
Sennor oujste enella: benedicta posada
...
% Dizia ual me gloriosa: madre sancta maria
Vala me la tu gracia: oy eneste dia
Ca so en grant affruento: en mayor non podria
Madre non pares mjentes: ala mj grant follia
% Abes podio el monge: la palabra conplir
Vino sancta maria: como solia uenjr
Con vn palo en mano: por al leon ferir
Metiosselis en medio: enpeço de dezir
% Don falso traydor: non uos escarmentades
Mas yo uos dare oy: lo que uos demandades
Ante lo conpraredes: que daquj uos uayades
Con quien uolujestes guerra: qujero que lo sepades
% Enpeço li a dar: de grandes palancadas
Non podian las menudas: escusar las granadas
Lazraua el leon: abuenas dineradas
Non ouo en sus dias: las cuestas tan souadas
% Dizial la buena duenna: don falso traydor
Que siempre en mal andas: eres del mal sennor
Sy mas aquj te tomo: eneste derredor
Delo que oy tomas: avn tomaras peor
% Plogoli al diablo: quando lo mando yr
Nunca mas fue osado: al monge escarnjr
Ante passo grant tiempo: que podiesse guarir
Desfizo la figura: enpeço de foyr
% El monge que por todo esto: auja passado
Dela carga del ujno: non era bien folgado
Que ujno e que mjedo: aujan lo tan souado
Que tornar non podia: a su lecho usado
% La reygna preçiosa: e de preçio fecho
Tomo lo por la mano: leuolo para el lecho
Cubriolo con su manta: e con el sobrelecho
Pusol so la cabeça: el cabeçal derecho
% Demas quando lo ouo: en su lecho echado
Santiguol con su diestra: e fue bien sanctiguado
Amjgo dixol fuelga: ca eres muy lazrado
Con vn poco que duermas: luego seras folgado
% Pero esto te mando: afirmes te lo digo
Cras mannana demanda: afulan mj amjgo
Confiessa te con elli: e seras bien comjgo
Ca es buen omne: e dar tea buen castigo
% Quiero yo ir mj via: saluar algun coytado
Esso es mj deliçio: mj offiçio usado
Tu finca bendicho: a dios acomendado
Mas non se olbide: lo que te e mandado
% Dixol el omne bueno: duenna fe que deuedes
Vos qui en mj fiziestes: tan granadas merçedes
Qujero sauer quien sodes: o que nonbre auedes
Ca yo gano en ello: uos nada non perdedes
% Dixol la buena duenna: seas bien saujdor
Yo so la que pari: al uero saluador
Que por saluar el mundo: suffrio muerte e dolor
Al que fazen los angelos: serujçio e honor
% Dixo el omne bueno: esto es de creer
De ti podria sennora: esta cosa naçer
Dexate me sennora: los tus piedes tanner
Nunca en este mundo: uere tan grant plazer
% Contendia el monge: queria se leuantar
Por fincar los ynoios: los piedes li besar
Mas la uirgo gloriosa: nol qujso esperar
Qujtoseli de oios: ouo el grant pesar
% Nola podia a ella: por do yua ueer
Mas uedia grandes lumbres: redor della arder
Nola podia por nada: de uoluntat toller
Ffazia muy grant derecho: ca le fizo grant plazer
% Otro dia mannana: uenjda la luz clara
Busco al omne bueno: que ella li mandara
Ffizo su confession: con humjldosa cara
Noli çelo vn punto: de quanto que passara
% El maestro al monge: fecha la confession
Dioli conseio bueno: dioli absoluçion
Metio sancta maria: en el tal bendiçion
Que ualio mas por elli: essa congregaçion
% Sy ante fuera bueno: fue despues meior
A la sancta reygna: madre del criador
Amola siempre mucho: fizol siempre honor
Ffelix fue el quj ella: cogio ensu amor
% El otro omne bueno: nol sabria nonbrar
Al que sancta maria: lo mando maestrar
Cogio amor tan firme: de tanto la amar
Que dexar se ya por ella: la cabeça cortar
% Todas las otras gentes: legos e coronados
Clerigos e calonges: e los escapulados
Ffueron dela gloriosa: todos en+amorados
Que saue acorrer: tan bien. alos cuytados
% Todos la bendizian: e todos la laudauan
Las manos e los oios: aella los alçauan
Retrayan los sus fechos: las sus laudes cantauan
Los dias e las noches: en esso los passauan
% Sennores e amjgos: mueba nos esta cosa
Amemos e laudemos: todos ala gloriosa
No echaremos mano: en cosa tan preçiosa
Que tan bien nos acorra: en hora peligrosa
% Sy nos bien la serujeremos: que quier queli pidamos
Todo lo ganaremos: bien seguros seamos
Aquj lo entendremos bien: ante que muramos
E lo que alli metieremos: que bien lo empleamos
% Ella nos de su gracia: e su bendiçion
Guarde nos de peccado: e de tribulaçion
De nuestras liujandades: gane nos remjssion
Que non uayan las nuestras: almas enperdiçion
De commo vna abbadessa fue prennada
Et por su conbento fue acusada
Et despues por la uirgen librada
SEnnores e amjgos: conpanna de prestar
De que dios se uos quiso: traer aeste logar
Aun sy me qujsiessedes: un poco esperar
A un otro mjraglo: uos querria fablar
% De vn otro mjraglo: uos querria contar
Que fizo la gloriosa: estrella dela mar
Sy oir me qujsieredes: bien podedes Jurar
Que de meior uocado: non podriades tastar
% Enlos tiempos derechos: que corria la uerdat
Que non dirian por nada: los omnes falsedat
Estonçe ujujan abuenas: uenjan a uegedat
Vedian asus trasnjetos: en septima edat
% Ffazia dios por los omnes: mjraglos cutiano
Ca non queria njnguno: mentir asu xpistiano
Aujan tiempos derechos: ybierno e uerano
Semeiaua el mundo: que todo era plano
% Sy peccauan los omnes: facian bien penjtençia
Perdonaua lis luego dios: toda mal querençia
Aujan con Jhesu xpisto: toda su atenençia
Qujero uos dar aesto: vna buena sentençia
% De vna abbadessa: uos qujero fer conseia
Que peco en buen punto: como amj semeia
Qujsieron li sus duennas: reuoluer mala çeia
Mas non li enpeçieron: ualiente vna arbeia
...
% Sennora benedicta: non te podi serujr
Pero ame te siempre: laudar e bendezir
Sennora uerdat digo: e non cuydo mentir
Querria seer muerta: sy podiesse morir
% Madre del rey de gloria: delos çielos reygna
Mane dela tu graçia: alguna medicina
Libra de mal porfazo: vna muger mezquina
Esto si tu qujsieres: puede seer ayna
% Madre por el amor: del tu fijo querido
Ffijo tan sin enbargo: tan dulze e tan cumplido
Non finque repoyada: esta merçed te pido
Ca ueo que me segudan: sobre grant apellido
% Sy non prendes sennora: de mj algunt conseio
Seo mal agujsada: de sallir a conçejo
Aquj quiero morir: enesti logareio
Ca sy alla salliero: fer me an mal trebeio
% Reygna coronada: templo de castidat
Ffuente de mjsericordia: torre de saluedat
Ffes en aquesta cuyta: alguna piadat
En mj non se agote: la tu grant piadat
% Qujero contra tu fijo: dar ati por fiança
Que nunca mas no torne: en aquesta errança
Madre sy fallesçiero: fes en mj tal uengança
Que todo el mundo fable: dela mj mal andança
% Tan affincada mente: fizo su oraçion
Que la oyo la madre: llena de bendiçion
Como quj amodorrida: uio grant ujsion
Tal que deuja en omne: fazer edifficaçion
% Traspuso se la duenna: conla grant cansedat
Dios lo obraua todo: por la su piadat
Appareçiol la madre: del rey de magestat
Dos angeles con ella: de muy grant claredat
% Ouo pauor la duenna: e fue mal espantada
Ca de tal ujsion: nunca era usada
Dela grant claridat: fue muy enbargada
Pero dela su cuyta: fue mucho alibiada
% Dixoli la gloriosa: afforzat abbadessa
Bien estades comjgo: non uos pongades quexa
Sepades que uos trayo: muy buena promessa
Meior que non querria: la uuestra prioressa
% Non ayades nul mjedo: de caer enporfazo
Bien uos a dios guardada: de caer en esse lazo
Bien lis yo aosadas: a tener lis el plazo
Non lazrara por ello: el uuestro espinazo
% A sabor del solaz: dela uirgo preçiosa
Non sintiendo la madre: de dolor nulla cosa
Nasçio la criatura: cosiella muy fermosa
Mandola alos angeles: tomar la gloriosa
% Dixolis alos angeles: auos ambos castigo
Leuat este njnnuelo: afulan mj amjgo
Dezid le que melo crie: yo asy gelo digo
Ca bien uos creera: luego seed comjgo
% Moujeron se los angeles: a muy grant ligereza
Recabdaron la cosa: syn njnguna pereza
Plogol al hermjtano: mas que con grant riqueza
Ca de uerdat bien era: vna rica nobleza
% Recudio la parida: fizo se sanctiguada
Dixo. ual me gloriosa: reygna coronada
Sy es esto uerdad: o sy so engannada
O sennora bendicta: ual a esta errada
% Palposse con sus manos: quando fue recordada
Por ujentre por costados: e por cada yiada
Ffallo su ujentre laçio: la çinta muy delgada
Como muger que es: de tal cosa librada
% Nol podia creer: por njnguna manera
Cuydaua que fue suenno: non cosa uerdadera
Palposse e catosse: la uegada terçera
Ffizosse dela dubda: en cabo bien çertera
% Quando se sintio delibre: la prennada mezquina
Ffue el saco uazio: dela mala farina
Enpeço con grant gozo: cantar salue regina
Que es delos cuytados: solaz e mediçina
% Ploraua delos oios: de muy grant alegria
Dizia laudes preciosas: ala uirgo maria
Non se temja del obispo: njn de su confradia
Ca termjnada era: dela fuerte malabtia
% Ploraua delos oios: e fazia oraçiones
Dizia ala gloriosa: laudes e bendiçiones
Dizia laudada seas: madre todas sazones
Laudar te deuen siempre: mugeres e barones
% Era en fiera cuyta: e en fiera pabura
Cay alos tus piedes: dixi te mj ardura
Acorriome sennora: la tu buena mesura
Deues seer laudada: de toda criatura
% Madre yo sobre todos: te deuo bendizir
Laudar magnjficar: adorar e serujr
Que de tan grant Jnfamja: me quisisti guarir
Que podria todo el mundo: siempre de mj reyr
% Sy esta mj nemjga: salliesse a conçeio
De todas las mugieres: seria riso sobeio
Quand grande es. e quan bueno: madre el tu conseio
Nolo asmaria omne: njn grande njn poquilleio
% Nolo sabria madre: yo ati gradeçer
La merçed e la gracia: que me quisisti fazer
Nin lo podria madre: yo nunca meresçer
Mas no çessare nunca: ati graçias render
% Bien fincaria la duenna: ensu contemplaçion
Laudando ala gloriosa: faziendo oraçion
Mas ujnoli mandado: dela congregaçion
Que fuesse a cabildo: fazer responsion
% Como enel porfazo: non se temja caer
Ffue luego alos piedes: del obispo seer
Qujsol besar las manos: ca lo deuja fazer
Mas el non gelas qujso: aella offrezer
% Enpeçola el obispo: luego a encrepar
Que auja fecha cosa: por que deuja lazrar
E non deuja por nada: abbadessa estar
Nin entre otras monJas; non deuja abitar
% Toda monJa que faze: tan grant desonestat
Que non guarda su cuerpo: njn tiene castidat
Deue seer echada: dela soçiedat
Alla por do qujsiere: faga tal suziedat
% Sennor dixo li ella: por que me maltraedes
Non so por auentura: tal como uos tenedes
Duenna dixo el obispo: por que uos lo negedes
Non seredes creyda: ca aprouar seredes
% Duenna dixo el obispo: sallit uos al hostal
Nos auremos conseio: despues faremos al
Sennor dixo la duenna: non dezides nul mal
Yo a dios me acomjendo: el que puede. e ual
% Sallio la abbadessa: fuera del consistorio
Como mando el obispo: fue para el diuersorio
Ffizieron su cabildo: la yra e el odio
Amassaron su massa: de farina de ordio
% Dixolis el obispo: amjgas non podemos
Condenar esta duenna: menos quela prouemos
Dixoli el conuento: delo que bien sauemos
Sennor en otra prueba: nos por que entraremos
% Dixolis el obispo: quando fuere uençida
Vos seredes mas saluas: ella mas confondida
Sy no nuestra sentencia: seria mal retrayda
Noli puede en cabo: prestar nulla guarida
% Enbio de sus clerigos: en quj el mas fiaua
Que prouassen la cosa: de qual gujsa estaua
Qujtaron li la saya: maguer que li pesaua
Ffallaron la tan seca: que tabla semeiaua
% Non fallaron en ella: signo de prennedat
Nin leche njn batuda: de mala malueztat
Dixieron non es esto: sy non grant uanjdat
Nunca fue leuantada: tan fiera falsedat
% Tornaron al obispo: dixieron li sennor
Sabet que es culpada: de balde la soror
Quj quier que al uos diga: salua uuestra honor
Dize tan grant mentira: que non podria mayor
% Cuydosse el obispo: que eran deçebidos
Que lis auja la duenna: dineros prometidos
Dixo. donnos maliellos: non seredes creydos
Ca otra quilma tiene: de yuso los uestidos
% Dixo. non uos lo quiero: tan ayna creer
O sodes bergonçosos: o resçibiestes auer
Yo quiero esta cosa: por mjs oios ueer
Sy no qui lo apuso: lo deue padesçer
% Leuantosse el obispo: onde estaua posado
Ffue para la abbadessa: sannoso e yrado
Ffizo li despoiar: la cugulla priuado
Prouo quele apponjan: crimen falso prouado
% Tornosse al conuento: brauo e muy fellon
Duennas dixo: fiziestes. vna grant trayçion
Pusiestes la sennora: en tan mala razon
Que es muy despreçiada: uuestra religion
% Esta cosa non puede: syn iustiçia passar
La culpa que quisiestes: uos en ella echar
El decreto lo manda: en uos deue tornar
Que deuedes seer: echadas deste logar
% Vio la abbadessa: las duennas mal Juzgadas
Que aujan a seer: dela casa echadas
Saco aparte al obispo: bien aquinze passadas
Sennor dixo las duennas: non son mucho culpadas
% Dixoli su fazienda: por que era passada
Por sus graues peccados: como fue engannada
Como la acorrio: la uirgo coronada
Sy por ella non fuesse: fuera mal porfazada
% E como mando ella: el njnnuelo leuar
Como al hermjtanno: gelo mando criar
Sennor sy uos quisierdes: podedes lo prouar
Por caridat non pierdan: las duennas el logar
% Mas quiero yo sennera: seer enbergonçada
Que tanta buena duenna: sea desamparada
Sennor merced uos pido: perdonat esta uegada
Por todas amj sea: la penjtençia dada
% Espantosse el obispo: fue todo demudado
Dixo duenna siesto: puede seer prouado
Vere en don ihesu xpisto: que es uuestro pagado
Yo mjentre fuero ujuo: fare uuestro mandado
% Enbio dos calonges: luego al hermjtanno
Prouar esto si era: o uerdat o enganno
Ffallaron al buen omne: en habito estranno
Tenjendo el njnnuelo: enbuelto en vn panno
% Mostrolis el Jnfante: reziente nasçido del dia
Dixo que lo mandara: criar sancta maria
Quj enesto dubdasse: faria grant bauequia
Ca era uerdat pura: e non uallitanja
% Tornaron al obispo: luego con el mandado
Dixieron li por nuebas: lo que aujan prouado
Sennor dixieron desto: sey çertificado
Sy non faras grant yerro: ganaras grant peccado
% Touo se enla duenna: el obispo por errado
Cayoli alos pies: enel suelo prostrado
Duenna dixo merçet: ca mucho e errado
Ruego uos que me sea: el yerro perdonado
% Sennor dixo la duenna: por dios e la gloriosa
Catat uuestra mesura: non fagades tal cosa
Vos sodes omne sancto: yo peccadriz doliosa
Sy en al non tornades: sere de uos sannosa
% La duenna con el obispo: auja esta entençia
Mas acabaron lo todo: en buena abenençia
Ya mas oujeron ambos: amor e bien querencia
Ençerraron su ujda: en buena abenencia
% Metio paz el obispo: enla congregaçion
Amato la contienda: e la dissension
Quando quiso despedir se: diolis su bendiçion
Ffue buena para todos: essa ujsitaçion
% Enbio sus saludes: al sancto ermjtanno
Como a buen amjgo: a conpadre fontano
Que criasse el njnno: fatal septeno anno
Desende el pensaria: de ferlo buen xristiano
% Quando ujno el termjno: los siete annos passados
Embio de sus clerigos: dos delos mas honrrados
Que traxiessen el njnno: del monte alos poblados
Recabdaron lo ellos: como bien castigados
% Traxieron el njnno: enel yermo criado
Delos dias que era: era bien ensennado
Plogoli al obispo: fue ende muy pagado
Mandol poner aletras: con maestro letrado
% Salio muy buen omne: en todo mesurado
Paresçie bien que fuera: de buen amo criado
Era el pueblo delli: todo mucho pagado
Quando murio el obispo: dieron li el obispado
% Guiolo la gloriosa: que lo dio acriar
Sabia su obispado: con dios bien gouernar
Guyaua bien las almas: como deuja guiar
Sabia en todas cosas: mesura bien catar
% Amauan lo calonges: e todas las mongias
Amauan lo pueblos: elas sus clerizias
Todos por onde estauan: rogauan por sus dias
Ffuera algunos foles: que amauan folias
% Quando ujno el termjno: ouo de finar
No lo dexo su ama: luenga mente lazrar
Leuolo ala gloria: a seguro logar
Do ladron njn merino: nunca puede entrar
% A la uirgo gloriosa: todos gracias rendamos
De quj tantos mjraglos: leemos e prouamos
Ella nos de su gracia: que serujr la podamos
E nos guje fazer cosas: por do saluos seamos Amen
SEnnores sy quisieredes: mjentre dura el dia
Destos tales mjraglos: aun mas uos diria
Sy uos non uos quexassedes: yo non me quexaria
Ca como pozo fondo: tal es sancta maria
% Tal es sancta maria: como el capdal rio
Que todos beuen delli: bestias e el gentio
Tan grande es cras: como eri: e non es mas uazio
En todo tiempo corre: en caliente e enfrio
% Siempre a corre ella: en todos los lugares
Por ualles e por montes: por tierras e por mares
Quj rogar la sopiesse: con limpios paladares
Non lo podrian torçones: tomar alos yJares
% Leemos vn mjraglo: dela su sanctidat
Que cuntia avn obispo: omne de caridat
Que fue omne catholico: de gran autoridat
Vio lo por sus oios: bien sauja la uerdat
% Assy como lo ujo: assy lo escriujo
Non menguo dello nada: nada no ennadio
Dios li de parayso: ca bien lo comedio
Alguna mjssa dixo: que tanto nol ualio
% Cruzaron se romeros: por yr en ultra mar
Saludar el sepulcro: la uera cruz orar
Metieron se en naues: para acre passar
Sy el padre del çielo: los quisiesse gujar
% Oujeron ujentos banos: luego dela entrada
Orage muy sabroso: toda la mar pagada
Aujan gran alegria: la alegre mesnada
Con tal tiempo ayna: aurian la mar passada
% Auian buena partida: dela mar trauessada
Que la aurian ayna: ala otra parte passada
Mas touolis su fado: vna mala celada
Ffue la gran alegria: en tristiçia tornada
% Moujosse la tempesta: vna oriella braua
Dessarro el maestro: que la naue gujaua
Nin assy. njn a otri: nul conseio non daua
Toda su maestria: non ualia vna faua
% Cuntiolis otra cosa: otra grant ocasion
Ronpiosse lis la naue: yuso enel fondon
Vedian entrar grant agua: ronpia cada rincon
Auja de yr la cosa: toda en perdiçion
% Cerca la mayor naue: trayan otra pocaza
Non se sy le dizian: galea o pinaza
Que sy fuessen cuytados: de oriella malbaza
En essa estorçiessen: dela mala pinaza
% Ffizo el marinero: como leal xpistiano
Asu sennor el obispo: tomol por la mano
Con bonos omnes: de pleyto mas lazano
Metiolos enla barca: tomo conseio sano
% Vno d pelegr: cuydo seer ero
Dio salto dela naue: bien ligero
Cuydo enla galea: por
Enfogose enel agua: ero
% Abes podia seer: media hora cunplida
Qujso lo dios fue la naue s
Dela gente que en reman
Por mediçina vno: no escapo aujda
% El obispo e los otros: que con elli sallieron
Salieron a no: do mas çerca
Ffz muy gran duelo: por los que perescieron
Pesaualis porque con ellos:
% Aujendo de los muertos: duelo grande e sar
Estendieron los oios: catauan ala mar
Sy u delos muertos: algunos arribar
Cl mar nunca qujere: cosa muerta celar
% Catando si algunos: muertos podrian ueer
Por dar lis co: so tierra los meter
Vidieron paljellas: de so la mar nacer
Quantos fueron los muertos: tantos
% Vidieron palomjellas: salir mar
Mas blancas que las njeues: co el cielo uolar
Credian que eran almas: que queria dios leuar
De derecha J: se quer desqujzar
% El sancto parayso: vn glorioso logar
Por que fincaron ujuos: aujan gran pesar
Ca tenjan bien afirmes: non era de dubdar
Que almas eran dessos: de los que o la mar
% Dizian ay romeros: uos fuestes dos
Que ya sodes p : e por agua passados
Nos finc en yermo: como desam
Nos uos: ca uos des segurados
% Grado al padre sancto: sa
Ya uestides la romeria
Nos somos isticia: e uos alegria
Nos cuydamos se: e fizi follia
% Aujendo gr queb: del danno que lis ujno
Querian tod su jno
V : sallir vn pgrino
Semei que era:
% ndo : que fue enla bera
Conoscieron lo : qu: salio
Sanctiguaronse todos: como por qual manera
Ffinco enel mar ujuo: vna hora snera
% Dixo el peregrino: me sy uades
ros: en esso que d
Como esca : quiero que lo sepades
: quelo oyades
% Quando : qujse fuera salir
Que pas qu sobjr
Vd podia guarir
enpece adizir
% Dixi esta sancta maria
mas uagar auja
Fue luego ella ps: por su plazenteria
Sy ella: fogado seria
% Luego ella: vn buen panno
su no
Echo
Cue do que uist
% Nunca tan rica obra: ujo omne carnal
Obra era angelica: cras era material
Tan folgado yaz: so vn tendal
O como quj se duerme: en vn uerde pradal
% Ffelix sera la alma: e bien auenturada
Que so tan rica sonbra: fuere asolazada
Nin frio njn calura: njn ujento njn elada
Noli fara enoio: que sea enbargada
% So esti panno fuelgan: alegres e pagadas
Las uirgines gloriosas: de don xpisto amadas
Que cantan asu madre: laudes multiplicadas
E tienen las coronas: preçiosas e ondradas
% La sombra daquel panno: tras tal tempradura
Omne con el arbol: falla so el folgura
Ffalla el frioliento: temprada calentura
Dios que rico conseio: enhora de ardura
% Tantas son sus merçedes: tantas sus caridades
Tantas las sus uirtudes: tantas las sus bondades
Que non las cantarian: obispos njn abbades
Nin las podrian asmar: reyes njn potestades
% El pesar que oujeron: delos que peligraron
Con sauor del mjraglo: todo lo olbidaron
Rendieron a dios gracias: el te deum cantaron
Desende salue regina: dulçe mente la finaron
% Cumplieron los romeros: desende su romeria
Allegaron al sepulcro: con muy grant alegria
Adoraron la cruz: del fijo de maria
Nunca eneste mundo: vidieron tan buen dia
% Contaron el mjraglo: dela madre gloriosa
Como libro al omne dela mar peligrosa
Dizian todos que fuera: vna estranna cosa
Ffizieron ende escripto: leyenda muy sabrosa
% Quantos que la oyeron: esta sancta razon
Todos ala gloriosa: dizian grant bendiçion
Aujan para serujrla: meior deuoçion
Ca esperauan della: merçet e gualardon
% La fama desti fecho: uolo sobre los mares
Nola retouo ujento: poblo muchos solares
Metieron la en libros: por diuersos logares
Onde es oy bendicha: de muchos paladares
% Quantos quela bendizian: ala madre gloriosa
Par el rey de la gloria: fazen derecha cosa
Ca por ella saliemos: dela carçel penosa
En quj todos yaziamos: foya muy peligrosa
% Los que por eua fuemos: en perdiçion caydos
Por ella recobramos: los solares perdidos
Sy por ella non fuesse: yaziamos amortidos
Mas el su sancto fructo: nos ouo redemjdos
% Por el su sancto fructo: que ella conçibio
Que por salut del mundo: passion e muerte suffrio
Saliemos dela foya: que adam nos abrio
Quando sobre deujedo: el mal bocado mordio
% Desende siempre contiende: en valer acuytados
Gouernar los mezquinos: reuocar los errados
Por tierras e por mares: fer mjraglos granados
Tales e muy mayores: delos que son passados
% Ella que es de gracia: plena e abondada
Guje nuestra fazienda: nuestra ujda lazrada
Guarde nos eneste mundo: de mala sorrostrada
Gane nos enel otro: con los sanctos posada. Amen
Amjgos sy qujsierdes: vn poco atender
Vn precioso mjraglo: uos querria leer
Quando fuere leydo: abredes grant plazer
Preçiar lo edes mas: que mediano comer
% Enla çiudat que es: de constantin nombrada
Ca constantin la ouo: otro tiempo poblada
El que dio a sant pedro: roma para posada
Auja y vn buen omne: de fazienda granada
% Era esti burges: de muy gran coraçon
Por subir en grant preçio: fazia muy gran mjssion
Espendia sus aueres: daualos en baldon
Qui qujer que li pidiesse: el non dizia de non
% Por ensalçar su fama: en su preçio creçer
Ermaua syn duelo: quanto podia auer
Sil menguaua lo suyo: aun por mas ualer
Tomaua de sus uezinos: prestado uolenter
% Derramaua lo suyo: larga mente e syn tiento
Menguauan los aueres: mas non el buen taliento
Siempre fallaria omne: en su casa conujento
Quando veynte quando treynta: alas de uezes çiento
% Como fazia grant gasto: espensa syn mesura
Ffalleçia la pecunja: parosse en ardura
Non fallaua prestado: nj fallaua a usura
Ni entre los estrannos: nj entre su natura
% Entendieron gelo todos: que era enpobrido
Non fallaua enprestado: nj auer encreydo
Era en gran porfazo: el buen omne caydo
Tenja quelo passado: era todo perdido
% El baron con grant quexa: fue ante los altares
Ffazia su oraçion: entre sus paladares
Sennor que vn dios eres: e tres personas pares
Sea tu piadat: e non me desampares
% Sennor fasta agora: tu me has captenjdo
So ya por mjs peccados: enfalliment caydo
El preçio que auja: todo lo e perdido
Mucho mas me ualiera: que non fuesse nasçido
% Sennor dame conseio: por alguna manera
Enbia me tu gracia: por alguna carrera
Es para ti tal fecho: cosa assaz ligera
Nade todo el mar: morire. enla ribera
% Demjentre que oraua: quiso li dios prestar
Ouo vn buen conseio: el burges a asmar
Non ujno por su seso: mas quiso lo dios gujar
El que el mundo todo: aue de gobernar
% Vn Judio bien rico: auja enla çipdat
Non auja del mas rico: en essa uezindat
Asmo de yr aelli: entre su voluntat
Demandarli prestado: por dios e caridat
% Ffue luego al Judio: e fue bien reçebido
Demandol como andaua: por que era uenjdo
Ca de otras sazones: lo auja conoscido
E todo el su pleyto: bien lo auja oydo
% Dixoli su fazienda: el burges al hebreo
Don fulan bien sabedes: mj pleyto como creo
Ganar de uos enprestado: auja grant deseo
Ca non cuyde ueer me: enesto que me ueo
% Quando dios lo queria: que yo algo auja
Sabenlo mjs uezinos: yo a todos ualia
Las puertas de mj casa: aujertas las tenja
Quanto que dios me daua: con todos lo partia
% Querria sy podiesse: en esso contender
Mas soy muy decaydo: menguado del auer
Mas sy tu me quisieres: del tuyo a creer
Bien te lo cuydaria: avn plazo render
% Dixoli el Judio: fazer lo e de buen grado
Darte quanto qujsieres: de mj auer prestado
Mas dame fiador: que sea segurado
Sy non pauor abria: de seer engannado
% Dixo li el xpistiano: fablo li con sabor
Don fulan non te puedo: dar otro fiador
Mas darte a xpisto: mj dios e mj sennor
Ffijo dela gloriosa: del mundo redemptor
% Dixoli el Judio: yo creer non podria
Que essy que tu dizes: que nasçio de maria
Que dios es: mas fue omne cuerdo. e syn folia
Profeta uerdadero: yo al non creria
% Sy el te enfiare: yo por la su amor
A creer te lo mjo: syn otro fiador
Mas semeia me cosa: esqujua syn color
E semeias me fascas: omne escarnjdor
% Yo non se de qual gujsa: lo podiesses auer
Ca non se eneste mundo: segunt el mj creer
Non esperes que uenga: por ati acorrer
Onde otro conseio: te conujene prender
% Respondio el xpistiano: dixoli al Judio
Entiendo que me tienes: por loco e sendio
Que non trayo conseio: e ando en radio
Mas al ueras tras esto: segunt que yo fio
% Dixoli el Judio: sy tal cosa mostrares
Yo te dare enpresto: quanto tu demandares
Mas por otras pastrijas: lo que de mj leuares
Non pagaras con ello: caçurros njn ioglares
% Dixoli el burges: al trufan regnegado
Solo que tu comjgo: uengas al mj sagrado
Mostrar te a maria: con el su buen criado
Dixoli el Judio: fazer lo e de grado
% Leuo lo ala iglesia: con dios e con su guya
Mostroli la ymagen: la de sancta maria
Con su fijo en braços: la su dulçe conpannja
Ffueron enbergonçados: los dela Juderia
% Dixo el omne bueno: alos dela aljama
Esti es nuestro sire: e esta nuestra dama
Siempre es bien apreso: qui aellos se clama
Quj en ellos non cree: bebra fuego e flama
% Dixo li al Judio: que era mayoral
Estos son mjs sennores: e yo su serujçial
Estos sean fianças: ca non puedo fer al
Aquj le prometio: quel prestaria cabdal
% Dixoli el Judio: yo bien los tomare
Yo otros fiadores: non te demandare
Mas sy tu me fallieres: a ellos reptare
E qual lealtat traes: sabiente lo fare
% Dioli los fiadores: al trufan el xpistiano
A madre e a fijo: metiogelos por mano
Pusieron de su paga: su termjno çertano
Resçibio su pecunja: el burges çibdadano
% Quando el auer ouo: el burges resçebido
Ouo grant alegria: touosse por guarido
Torno ala gloriosa: fue de buen sentido
Ffue render gracias a dios: de coraçon conplido
% Abbaxo los ynoios: ante la magestat
Leuanto a dios los oios: con grant humjldat
Sennor dixo. feziste me: merçed e caridat
As me oy sacado: de muy grant pobredat
% Sennor andaua eri: pobre e adebdado
So oy por tu gracia: rico e abondado
A ti di por fiança: mas fizilo syn grado
Por mj seria grant tuerto: que tu fuesses reptado
% Sennor yo non querria: de mj palabra fallir
Lo que ante ti pusi: bien lo querria conplir
Pero sy non podiero: yo al plazo uenjr
El auer ante ti: lo querre aduzir
% Sennor sy por uentura: fuero yo alongado
Que non pueda uenjr: al termjno taiado
Porrelo ante ti: que me as enfiado
E tu como qujera: fes lo ael pagado
% Reygna delos çielos: madre del pan de trigo
Por qui fue confondido: el mortal enemjgo
Tu eres mj fiança: esso mesmo te digo
Lo que e recontado: al que tienes contigo
% Quando el burges. ouo fecha su oraçion
E con el trufan: ouo puesta su condiçion
Agujso su fazienda: e toda su mjsion
Ffue a tierras estrannas: aluenga region
% Ffue a tierras estrannas: a flandes e a françia
Con grandes mercaduras: e fizo grant ganançia
Con dios ela gloriosa: creçio la su sustançia
Puyo a grant riqueza: e a grant alabançia
% Con las grandes ganançias: que era fazendado
Era dela tierra: fiera mente alongado
Non recudio al termjno: que ouo assentado
Por sus peccados graues: aujalo olbidado
% Cerca uenja el dia: que auja apagar
Mas de vn dia solo: non auja a passar
Ouo se el burges: del mal pleyto a remenbrar
Queria se el buen omne: con sus manos matar
% Dizia mal so fallido: mezquino peccador
Por nada noli puedo: ualer al fiador
Sera por mj reptado: el mj redemjdor
E la su madre sancta: la de rocamador
% Sennor tu lo entiendes: e sabes la uerdat
Como so tan pesante: entre mj uoluntat
Sennor da me conseio: por la tu piadat
Que non sea reptada: la tu grant maiestat
% Tomo el auer todo: en vn saco atado
Non fallia dela suma toda: vn puges foradado
Leuolo ala isla: asus cuestas trossado
Echolo enlas ondas: do no auja nul uado
% Torno en ihesu xpisto: con grant deuoçion
Plorando graue mente: fizo su oraçion
Sennor dixo tu lo saues: oda esta razon
Ca tu eres fiança: de nuestra condiçion
% Sennor quando non puedo: yo pagar al marquero
Ca nos yaze en medio: mucho brauo sendero
Sennor que eres dicho: saluador uerdadero
Tu pon esta pecunja: cras enel su cellero
% Sennora gloriosa: mjenna sancta maria
Tu bien en meyo yazes: enesta pleytesia
Quando bien la catares: mas que mja
A ti do la pecunja: sennora tu la guja
% Ambos tu e tu fijo: fuestes enel mercado
Ambos sodes fianças: al trufan renegado
Sea la merçed uuestra: e sea cras pagado
Por mal sieruo. non sea: el buen sennor reptado
% Yo auos lo comjendo: cuento que e pagado
Yo por quito me tengo: ca auos lo e dado
Yo madre ati ruego: tu ruega al criado
Como quier cras sea: el trufan entregado
% Plogo ala gloriosa: e al su fujo querido
Otro dia mannana: el sol bien esclarido
El basel que leuaua: el auer acreydo
Nadaua ala puerta: del trufan descreydo
% La ujlla do fazia: el Judio su morada
El que al burges ouo: la pe prestada
Yazia como leemos: cerca la mar poblada
Las ondas enlos muros: batian ala begada
% En essa matinada: ora de prima era
Los omnes del Judio: conpannuela baldera
Salieron deportarsse: fuera ala ribera
Vidieron esti estui: nadar sobre la glera
% Ffueron para tomarlo: mançebiellos liujanos
Estos muchas deuezes: fazian ensayos uanos
Encogia se adentro: fuyales delas manos
Esto uedian lo muchos: iudios e xpistianos
% Vinjeron al roydo: xristianos sabidores
Con garfios con guizquios: galeas uoladores
Todo non ualio nada: ca eran trufadores
Nunca omnes uertieron: tan baldados sudores
% Vino por auentura: el sennor uerdadero
Vinoli alas manos: adiesso el tablero
Leuolo asu casa: dentro ensu çellero
De oro e de plata: fizo vn grant rimero
% Quando el trufan ouo: el auer recapdado
El uaso en que ujno: fue bien escodrinnado
Echo lo so su lecho: rica mente alliujado
Aujan todos Jnujdia: del trufan renegado
% El trufan aleuoso: natura cobdiçiosa
Non metio el astroso: mjentes enesta cosa
Tenja que su uentura: era maraujllosa
Pusoli el burges: nonbre uoca mjntrosa
% Reptauale el aljama: essa mala natura
Que perdio su auer: por su mala locura
Nunca omne non fizo: tan loca fiadura
Que tomo por fiança: vna ymagen dura
% Dexemos al Judio: goloso e logrero
Nolo saque dios ende: aguarde su çellero
Ffablemos su uegada: del pleyto del mercadero
Leuemos li las nuebas: do ribo el tablero
% El burges de biançio: ujuja con grant pesar
Que non podio al plazo: al Judio pagar
Non podia el buen omne: la cara alegrar
Noli podian por nada: sus omnes confortar
% Andido vn grant tiempo: gano muchos dineros
Conprando e uendiendo: aley de mercaderos
Quando la hora ujo: dexo estos senderos
Torno asu proujnçia: con otros conpanneros
% Ffue por costantinopla: sembrando el roydo
El burges don ualerio: como era uenjdo
Plogoli al Judio: touose por guarido
Cuydo que doblaria: el auer acreydo
% Ffue luego ala casa: ca sabia do moraua
Pusolo enporfazo: por que non le pagaua
Dixoli el buen omne: que locura buscaua
Ca nada nol deuja: delo que demandaua
% Dixoli el Judio: yo con derecho ando
Ca buenos testigos tengo: delo que yo demando
Sy dizes que pagueste: demuestra do o quando
Ca encabo creo bien: que non yre cantando
% Ffie enel tu xpisto: vn grant galeador
E en su madrezilla: que fue poco mejor
Leuare tal derecho: qual pris el fiador
Quj mas en tj creyere: tal prenda o peor
% Dixoli el xpistiano: dizes palabra loca
Buena madre. buen fijo: aslis berguença poca
Nunca eneste mundo: tal muger cubrio toca
Ny nasçio nunca njnno: de tan donosa boca
% El auer que me diste: bien seo segurado
Buenos testigos tengo: bien te loe pagado
Aun sy de non dizes: fer te mayor mercado
Digan lo las fianças: que oujste tomado
% Ffue el trufan alegre: touose por guarido
Dixo iuyzio resçibo: non seras desmentido
Cuydo que la ymagen: que non auja sentido
Non fablaria palabra: por que fuesse uençido
% Ffueron ala iglesia: ambos estos guerreros
Ffazer esta pesqujsa: qual auja los dineros
Ffueron tras ellos muchos: emuchos delanteros
Veer sy aurian seso: de fablar los maderos
% Pararon se delante: del njnno coronado
El que tenja la madre: dulze mente abraçado
Dixoli el burges: sennor tan acabado
Departi esti pleyto: ca yo so mal reptado
% De como yo lo fiz: tu eres sabidor
Sy lo ouo o non: tu lo sabes sennor
Sennor tu faz tanta gracia: sobre mj peccador
Que digas sy lo ouo: ca tu fuiste fiador
% Ffablo el crucifixo: dixoli buen mandado
Miente que paga priso: enel dia taxado
El çesto en que ujno: el auer bien contado
So el su lecho mjsmo: lo tiene condessado
% Moujo el pueblo todo: como estaua plecho
Ffueronli ala casa: fizieron grant derecho
Ffallaron el escrinno: do yazia so el lecho
Ffinco el trufan malo: confuso e maltrecho
% Sil peso o sil plogo: triste e desmedrido
Ouo del pleyto todo: a uenjr conosçido
Elli con sus conpannas: fue luego conuertido
Murio enla fe buena: dela mala tollido
% Sienpre en essy dia: que cuntio esta cosa
Que fablo la ymagen: la su uirtut preciosa
Ffazian muy alta fiesta: con quirios e con prosa
Con grandes alegrias: a dios e ala gloriosa
% Los pueblos dela ujlla: pauperes e potentes
Ffazian grant alegria: todos con Jnstrumentes
Adouauan conviujos: dauan ad non habentes
Sus carnes sus pescados: salpresos e reçentes
% Andauan las redomas: con el ujno pimente
Conduchos adobados: maraujlosa mente
Quj tomar lo quisiese: non auria fallimente
Non trayan en su pleyto: njngunt escarnjmente
% Vn rico arçidiano: bien de tierras estrannas
Acaesçio essa fiesta: entre essas conpannas
Bio grandes quirolas: proçessiones tamannas
Que njn oyo njn ujo: otras destas callannas
% Pregunto esta fiesta: como fue leuantada
Ca era grant fazienda: noble mente çelabrada
Dixoli vn latino: la rayz profundada
E sopiesse que esta era: uerdat probada
% Plogol al arçidiano: touolo por grant cosa
Dixo laudetur deus: e la uirgo gloriosa
Metiolo en escripto: la su mano cabosa
Deli dios parayso: e folgança sabrosa Amen
Avn otro mjraglo: vos querria contar
Que fizo la gloriosa: non es de olbidar
Ffuente perennal es ella: de qui mana la mar
Que en njnguna sazon: non çessa de manar
% Bien creo que esti mjraglo. qui oyere
Noli querra quitar: la toca que cubriere
Nyn le querra por fuerça: quitar lo que toujere
Menbrar li deue esto: de mjentre que viujere
% Enel tiempo del rey: dela buena uentura
Don fernando por nonbre: sennor de estremadura
Nieto del rey alfonso: cuerpo de grant mesura
Cuntio esti mjraglo: de muy grant apostura
% Moujeron se ladrones: de parte de leon
De essa bjspalia: de essa region
Vinjeron a castiella: por su grant confusion
Gujolos el diablo: que es vn mal gujon
% El vno era lego: en duro punto nado
El otro era clerigo: de obispo ordenado
Legaron en çohynos: gujolos el peccado
El que gujo a Judas: fazer el mal mercado
% De fuera dela ujlla: en vna rellanada
Estaua vna iglesia: non mucho aredrada
Cerca dela iglesia: vna çiella poblada
Moraua enla çiella: vna toca negrada
% Barruntaron la cosa: ambos estos ladrones
Moujeron se de noche: con sendos açadones
Desqujçiaron las puertas: buscaron los rencones
Bien entendieron que era: la çiella syn uarones
% Pobre era la freyra: que mantenja la çiella
Auja magra sustançia: assaz poca ropiella
Pero auja vn panno: era cosa bonjella
Para muger de orden: cubierta e apostiella
% Lo que fue enla çiella: fue todo abarrido
Mala mente maneado: en vn saco metido
Assaz era el lego: omne de mal sentido
Mas de peor era el clerigo: que mas auja leydo
% Quando lo dela çiella: todo fue enbasado
Todo baldria bien poco: de auer monedado
Asmaron los astrosos: mjnjstros del peccado
Que yazia el prouecho todo: enla yglesia çerrado
% Ffue con los açadones: la çerraJa rancada
Desquiçiadas las puertas: la iglesia robada
De quanto que y era: non remaneçio nada
Ffazian grant sacrilegio: por ganançia delgada
% Despoiaron las sauanas: que cubrian el altar
Libros e uestimentas: con que solian cantar
Ffue mal desbaratado: el preçioso logar
Do solian peccadores: al criador rogar
% Quando oujeron fecha: esta tan grant locura
Alçaron contra suso: ambos la catadura
Dela uirgo gloriosa: ujdieron la figura
Con su njnno enbraços: la su dulze criatura
% Tenja enla cabeça: corona muy honrrada
De suso vna impla: blanca e muy delgada
Adiestro e sinjestro: la tenja colgada
Asmaron de quitargela: mas non ganaron nada
% Argudosse el clerigo: fizo se mas osado
Ca en cosas de iglesia: el era mas usado
Ffue trauar dela toca: el mal auenturado
Ca con esso abrian: su pleyto acabado
% Touosse la gloriosa: que era afontada
Que tan villana mente: la aujan despoiada
Mostro que del serujçio: non era muy pagada
Nunca ujeron omnes: toca tan querellada
% Luego que dela toca: trauo el mal auzado
Pego se li tan firme: enel punno çerrado
Que con englute njnguno: non seria tan trauado
Nin con clauo que fuesse: de martillo calcado
% Perdieron la memoria: ca bien lo mereçieron
El lego e el clerigo: todo el seso perdieron
Ffueron para la puerta: hallar nola podieron
Andauan en radio: los que por mal naçieron
% Delo que aujan tomado: non se podian qujtar
Ya lo querrian de grado: sy podiessen dexar
Dexar lo yan de grado: nolo querian leuar
Mas de era la puerta: nolo sabian asmar
Andauan tanteando: de rencon en rencon
Como fazia sisinnjo: el çeloso uaron
Marido de teodora: muger de grant cançion
La que por clemens papa: tomo religion
% Los locos malastrugos: de dios desanparados
Andauan como beodos: todos descalabrados
Oras dauan de rostro: oras delos costados
De yr en romeria: estauan mal gujsados
% La freyra con la perdida: que auja reçebida
Salio como pudo: onde yazia escondida
Metio uozes e gritos: fue luego acorrida
La gente mas liujana: adiesso fue uenjda
% Ffueron luego uenjdos: grant gente de peones
Entraron enla iglesia: fallaron los ladrones
Manentraron lis luego: como uenjan fellones
Darlis grandes feridas: con muy grandes bastones
% Dauanlis grandes palos: e grandes carrelladas
Coçes muchas sobeio: e muchas palancadas
Leuauan por los cuerpos: tantas delas granadas
Que todas las menudas: lis eran olbidadas
% Ffizieron lis dezir: toda la pleytesia
De qual tierra ujnjeron: o por qual romeria
E como los auja: presos sancta maria
Por que li aujan fecha: ellos grant ujllanja
% Ante delos aluores: fueron bien recabdados
Quando el sol salio: fallo los bien domados
Clamauan lis los omnes: traydores prouados
Que contra la gloriosa: fueron tan denodados
% Luego las mjssas dichas: llegosse el conçeio
Todos aujan sauor: de fer lis mal trebeio
Sobrel lego cativo: tomaron mal conseio
Alzaron lo de tierra: con vn duro uençeio
% Vn calonge deuoto: omne de sancta ujda
Que tenja su amor: en dios bien ençendida
Quando ujo la toca: conla mano cosida
Dizia que tal Justiçia: nunca non fue oyda
% Qujso el omne bono: dela toca trabar
En uez dela gloriosa: el su uelo uesar
Mas al xpistiano bono: quiso lo dios onrrar
Despegosse la toca: adiesso del pulgar
% Ende a pocos de dias: lo qujso gujar
Acaeçio que ujno: el obispo al lugar
Traxieron li el clerigo: por gelo presentar
Veer sil mandaria: o tener o soltar
% Traxieron el clerigo: las manos bien atadas
Los ombros bien sobados: de buenas palancadas
Dixieron li las nuebas: delas sus trasnochadas
Como fazia las cosas: que dios auja uedadas
% Confesso li el mjsmo: con su mjsma boca
Toda su pleytesia: su mantenençia loca
Como ala gloriosa: despoiaron la toca
Nunca cosa fizieron: de ganancia tan poca
% Tomolo el obispo: leuo lo a leon
Manos atras atadas: a ley de ladron
Quantos quelo uedian: e sabian la razon
Dizian dios lo confonda: a tan loco uaron
% Non se atreujo el obispo: librar la pleytesia
Demando al conçilio: toda la clerezia
Quando fueron llegados: al asignado dia
Presentolis el clerigo: dixolis su folia
% Demandolis conseio: queli deuja fazer
Noli sopo njnguno: a ello responder
Sabia bien el obispo: derecho connosçer
Qujsolo por su boca: al clerigo uençer
% Dixol el obispo clerigo: tu feziste tal mal
O qual todos te fazen: otorgaste por tal
Sennor dixo el clerigo: mj padre spirital
Contra la mj maleza: nunca falle egual
% Quanto de mj te dizen: todo es grant uerdat
Non te dizen el diezmo: dela mj malueztat
Sennor por dios te sea: e por caridat
Non cates al mj merito: mas cata tu bondat
% Amjgos diz el obispo: esto es agujsado
Non es nuestro el clerigo: njn de nuestro obispado
Por nos non es derecho: que sea codempnado
Juzgue lo su obispo: su merçed su peccado
% Por del obispo de aujla. se es. el aclamado
Clamasse por su clerigo: e del su obispado
Juzgar ageno clerigo: por ley es uedado
Podria yo por ello: despues seer reptado
% Mas pongo tal sentençia: que sea acotado
Que sy fallado fuere: entodo este obispado
Sea luego prendido: en vn arbol colgado
El qujlo perdonare: sea descomulgado
% Nunca mas lo ujdieron: desque lo enbiaron
En todo el obispado: nunca lo testiguaron
El mjraglo nuebo: fuerte mente lo recordaron
Con los otros mjraglos: en libro lo echaron
% Tu madre gloriosa: siempre seas laudada
Que saues alos malos: dar mala sorrostrada
Saues honrrar los buenos: como bien ensennada
Madre de gracia plena: por ende eres llamada
% Los malos que ujnjeron: a furtar la tu çiella
Bien los tobiste presos: dentro en tu capiella
Al buen omne que quiso: besar la tu toquiella
Bien suelta gela diste: como diz la cartiella
% Sennora benedicta: reygna acabada
Por mano del tu fijo: don xpisto coronada
Libra nos del diablo: dela su çancaiada
Que tiene alas almas: siempre mala çelada
% Tu nos guja sennora: enla derecha ujda
Tu nos gana en cabo: fin buena e cumplida
Guarda nos de mal colpe: e de mala cayda
Que las almas en cabo: ayan buena salida Amen
DE como teofilo fizo carta
con el diablo de su anjma Et
despues fue conuertido & saluo
DEl pleyto de teofilo: uos querria fablar
Tan preçioso mjraglo: no es de olbidar
Ca enesso podremos: entender e asmar
Que uale la gloriosa: quj la saue rogar
% Non querre sy podiero: la razon alongar
Ca uos auriades enoio: yo podria peccar
Dela oracion breue: se suele dios pagar
A nos essa nos dexe: el criador usar
% Era vn omne bueno: de granada fazienda
Auja nonbre teofilo: como dize la leyenda
Onbre era pacifico: non amaua contienda
Bien sabia asus carnes: tener las. so su rienda
% Enel logar do era: contenja grant baylia
De su sennor el obispo: tenja la ujcaria
Delos dela iglesia: auja la meioria
Ffuera que el obispo: tenja la nonbradia
% Era ensy mesmo: de buena continençia
Sabia auer con todos: paz e grant abenençia
Omne era temprado: de alta conosçençia
Era muy bien condido: de seso. e de çiençia
% Vestia alos desnudos: apaçia los fanbrientos
Acogia los romeros: que uenjan friolientos
Daua alos errados: buenos castigamjentos
Que fiziessen penjtençia: de todos fallimjentos
% Non auja el obispo: enbargo njn lazerio
Ffuera cantar su mjssa: e rezar su salterio
Elli lo escusaua: de todo mjnjsterio
Contar las sus bondades: seria grant renunçerio
% Amaua lo el obispo: mucho de grant manera
Por que lo escusaua: de toda fazendera
Los pueblos e las gentes: aujan lo por lunbrera
Ca el era de todos: cabdiello e carrera
% Quando ujno el termjno: que ouo de finar
Non podio el obispo: el punto traspassar
Enfermo e murio: fue con dios a folgar
Deli dios parayso: sy se quiere rogar
% Los pueblos dela tierra: toda la clerizia
Todos dizian teofilo: aya la bispalia
Entendemos que yaze: enel la meioria
El conbiene que aya: la adelantadia
% Enbiaron sus cartas: al metropolitano
Por dios que de teophilo: non mudasse la mano
Ca esso tenjan todos: por conseio mas sano
Lo al seria ybierno: esto seria uerano
% Embiaron por elli: los del arçobispado
Dixieron li teofilo: toma esti obispado
Ca todo el cabildo: enti es otorgado
E de todos los pueblos: eres tu postulado
% Respondio lis teofilo: con grant simplicidat
Sennores mudat mano: por dios e caridat
Ca non so yo tan digno: para tal dignjdat
En fazer tal eleçion: seria grant ceguedat
% Dixo el arçobispo: qujero que uos fabledes
Esta election: qujero que la tomedes
Dixoli don teofilo: tanto non contendredes
Que atodo mj grado: a ello me leuedes
% Los dela calongia: sy lis plogo o non
Oujeron a fazer: otra election
El obispo que pusieron: enla ordenaçion
Puso otro ujcario: enla mjnjstracion
% Corrian los pleytos todos: al ujcario nouel
Serujendo a teofilo: mas plus serujan ael
Cogio zelo teophilo: çenpello el donzel
Canbio en cayn: el que fuera abel
% En casa del obispo: non era tan priuado
Como solia seer: con el otro passado
Ffue ensu uoluntat: fiera mente perturbado
Aujalo la Jnujdia: de su siesto sacado
% Tenjasse por mal trecho: e por occasionado
De grandes e de chicos: uediasse desdennado
Cego con grant despecho: e fue mal trastornado
Asmo fiera locura: yerro grande desgujsado
% Do moraua teofilo: en essa bispalia
Auja y vn Judio: en essa Juderia
Sabia el cosa mala: toda aleuosia
Ca con la hueste antigua: auja su confradria
% Era el trufan falso: lleno de malos uiçios
Sauja en+cantamjentos: e muchos malefiçios
Ffazia çercos el malo: e otros artefiçios
Belzebub lo gujaua: en todos sus offiçios
% En dar conseios malos: era muy saujdor
Mataua muchas almas: el falso traydor
Como era uassallo: de muy mal sennor
Sy el mal lo demandaua: este fazia lo peor
% Cuydauan se los omnes: que con seso quebraua
Non entendian que todo: sathanas lo gujaua
Quando por auentura: en algo açertaua
Por poco la gente loca: que nolo adoraua
% Aujalo el diablo: puesto en grant logar
Todos a el ujnjan: conseio demandar
Lo que lis el dizia: fazia gelo probar
Sauja de mala gujsa: los omnes engannar
% Tenjan lo por propheta: todos chicos e grandes
Todos corrian a elli: como puercos alandes
Los que enfermos eran: leuauan los en andes
Todos dizian faremos: que quier que tu nos mandes
% Teofilo mezquino: de dios desamparado
Vençiolo su locura: e muebda del peccado
Ffue demandar conseio: al trufan diablado
Como podria tornar: al antigo estado
% Dixoli el Judio: sy creer me qujsieres
Rehez puedes tornar: en esso que quieres
Non ayas nulla dubda: sy tu firme estoujeres
Todo es recabdado: sy non te repintieres
% Respondioli teofilo: como enbellinnado
Por esso ujnj ati: por segujr tu mandado
Dixoli el Judio: sey assegurado
Cuenta que el tu pleyto: todo es recabdado
% Ve folgar atu lecho: torna atu posada
Cras al suenno primero: la gente aquedada
Ffurta te de tus omnes: de toda tu mesnada
Ven tastar ala puerta: e non fagas al nada
% Ffue con esto teofilo: alegre e pagado
Touo todo su pleyto: que era bien parado
Torno asu posada: dura mente engannado
Mucho mas li ualiera: sy se fuesse quedado
% Luego la otra noche: la gente aquedada
Ffurtose de sus omnes: salio de su posada
Ffue a tastar ala puerta: ca sabia la entrada
El trufan estouo presto: abrioli syn soldada
% Tomolo por la mano: la noche bien mediada
Saco lo dela ujlla: a vna cruzeJada
Dixol. non te sanctigues: njn te temas de nada
Ca toda tu fazienda: sera cras meiorada
% Vio a poca hora: uenjr muy grandes gentes
Con çiriales en manos: e con çirios ardientes
Con su rey en medio: feos ca non luzientes
Ya querria don teofilus: estar con sus parientes
% Tomo lo por la mano: este trufan traydor
Leuo lo ala tienda: do estaua el sennor
Reçibio lo el rey: assaz agrant honor
Assy fizieron los prinçipes: quele estauan enderredor
% Dixol luego el rey: don fulan que buscades
Que presente me trahedes: quiero quelo digades
O que omne es esti: que uos me presentades
Saber lo quiero luego: esto bien lo creades
% Dixoli el Judio: sennor rey honrrado
Esti solia seer: ujcario del obispado
Querian lo todos mucho: era omne honrrado
Qujtaron lo agora: onde es menoscauado
% Por esso es uenjdo: atus pies caer
Que li fagas cobrar: lo que solia auer
El faga te seruiçio: a todo su poder
Auras enel uassallo: bueno amj creer
% Dixoli el diablo: non seria buen derecho
A uassallo aieno: yo buscar tal prouecho
Mas denjege a xpisto: que nos faz muy despecho
Ffazer le que torne: en todo su buen fecho
% Denjege asu xpisto: e a sancta maria
Ffaga me carta firme: a mj plazenteria
Ponga y su siello: ala postremeria
Tornara en su grado: con muy grant meioria
% Teofilo con gana: de enpreçio sobir
Al plazer del diablo: ouo a consentir
Ffizo con el su carta: e fizo la guarnjr
De su siello mesmo: que nol podiesse mentir
% Partiosse del con esto: torno asu posada
Cerca era de gallos: quando fizo la tornada
Nola entendio nadi: esta su caualgada
Ffuera dios al qual solo: non se encubre nada
% Pero perdio la sombra: siempre fue dessombrado
Perdio la color buena: fizo se descolorado
Pero dios se lo quiso: non por poder del peccado
Torno el malestrugo: en todo su estado
% Torno el fementido: entodo su estado
Connosçiosse el obispo: que auja mal errado
Que dela ujcaria: lo auja demudado
Sennor dixo teofilo: sea uos perdonado
% Sy ante fue teofilo: bien querido e amado
Ffue depues mas serujdo: e mucho mas preçiado
Dios sennero lo saue: que es bien decorado
Sil uenja por dios: o si por el peccado
% Viujo algunos dias: enesta bien andança
Aujendo con el obispo: amor e grant priuança
Recibiendo del pueblo: mucha rica pitança
Mas en cabo firiolo: xpisto con la su lança
% Estando esti ujcario: en esta ujcaria
Cogio muy grant iactançia: e grant uallitanja
Conçibio uana gloria: e grant eufanja
Entendian gelo todos: que traya lozanja
% El sennor que non quiere: muerte de peccadores
Mas que saluen las almas: emjenden los errores
Torno en esti enfermo: de mortales dolores
Que era engannado: de malos traydores
% Los bienes que fiziera: enlos tiempos troçidos
El buen sennor non quiso: queli fuessen perdidos
Reujsclo los sus sentidos: que yazian amortidos
Abrio luego los oios: que tenja adormjdos
% Respiro vn poquiello: torno ensu sentido
Comjdio su fazienda: ujosse mal tenjdo
Comjdio mas adentro: que auja prometido
Alli cayo teofilo: en tierra amorteçido
% Dixo entre sy mjsmo: mezquino mal fadado
Del otero que estouj: quj me a derribado
La alma he perdida: el cuerpo despreçiado
El bien que he perdido: nolo uere cobrado
% Mezquino peccador: non ueo do ribar
Non fallare qui quiera: por mj a dios rogar
Morre como quj yaze: en medio dela mar
Que non uede terreno: do pueda escapar
% Mezquino ha mj nasqui en hora dura
Mateme con mjs manos: matome mj locura
Auja me sentado dios: en buena mesura
Agora e perdida: toda buena uentura
% Mezquino por que quiera: tornar enla gloriosa
Que dize la escriptura: que es tan piadosa
Non me querra oyr: ca es de mj sannosa
Por quela denegue: fiz tan esqujba cosa
% Non ouo mayor culpa: Judas el traydor
Que por pocos dineros: uendio asu sennor
Yo peque sobre todos: mezquino peccador
Que por mj non sera: njnguno rogador
% So perdido con dios: e con sancta maria
Perdido con los sanctos: por mj aleuosia
Corte todas las çimas: do los piedes tenja
Sy naçido non fuesse: muy meior abria
% El dia del Juyzio: yo falso traydor
Con qual cara uerne: antel nuestro sennor
De mj fablaran todos: mezquino peccador
Non uerna ala yunta: de mj otro peor
% Vidi en hora mala: aquella ujcaria
Escuche al diablo: busque mj negro dia
Matome el trufan: el dela Juderia
Que mata otros muchos: con mala maestria
% Yo non auja mengua: njn andaua mendigo
Todos me fazian honrra: e plazialis comjgo
Mas fuj demandar: meior de pan de trigo
Yo busque mj cuchiello: fuy mj enemjgo
% Auja que uestir: auja que calçar
Auja para mj: auja para dar
Ffuy para mercado: dia negro buscar
Deuria me yo mesmo: con mjs manos matar
% Bien se que desta fiebre: non podre termjnar
Non a menge njn fisico: que me pueda prestar
Sy non sancta maria: estrella dela mar
Mas quj sera osado: que la uaya rogar
% Yo mezquino fediondo: que fiedo mas que can
Can que yaze podrido: no el que come pan
Non me querra oyr: esto solo de plan
Ca fuy contra ella: torpe e muy ujllan
% Que alos santos qujera: poner por rogadores
Como del mj mal pleyto: todos son saujdores
Sannosos me son martires: todos los confessores
Mucho mas los apostolos: que son mucho meiores
% Non quiero por los piedes: la cabeça dexar
Ala madre gloriosa: me quiero acostar
Cadre alos sus piedes: delante el su altar
Atendiendo su gracia: alli quiero finar
% Alli terre ieiunjos: fare afflictiones
Plorare delos oios: rezare oraçiones
Martiriare las carnes: çeuo de ueruençones
Ca metra en mj mjentes: en algunas sazones
% Maguer la denegue: como loco sendio
Que fuy engannado: por vn falso Judio
Ffirme mente lo creo: enla su merçed fio
Que della naçio xpistus: que fue saluador mjo
% Que uaya al su templo: cras de buena mannana
Venjr me a lo que ujno: ala egiptiana
Que tomo grant porfazo: como mala ujllana
Ffasta que la gloriosa: li fue entremediana
% Avn que melo suffra: dios por su piadat
Que pueda entrar dentro: ueer la maiestat
Verna fuego. o rayo: o otra tempestat
Ffara danno a muchos: por la mj mal+ueztat
% Avn que todo esto: me quiera dios suffrir
Que me dexe en paz: mj rencura dezir
En qual razon enpieçe: non puedo comedir
Nin asmo como pueda: la mj boca abrir
% Desamparo su casa: e quanto que tenja
Non dixo a njnguno: lo que fazer queria
Ffue para la iglesia: del logar do ujuja
Plorando delos oios: quanto mas se podia
% Echoseli a piedes: a sancta reygna
Que es de peccadores: conseio e madrina
Sennora dixo ualas: ala mj alma mezquina
Ala tu merçed uengo: buscarli medizina
% Sennora so perdido: e so desamparado
Ffiz mal encartamjento: e so mal engannado
Dy non se por qual gujsa: la alma al peccado
Agora lo entiendo: que fizi mal mercado
% Sennora benedicta: reyna coronada
Que siempre fazes preçes: por la gente desbiada
Non uaya repoyado: yo dela tu posada
Sy no diran algunos: que ya non puedes nada
% Sennora tu que eres: puerta de parayso
En quj el rey de gloria: tantas uondades mjso
Torna en mj sennora: el tu preçioso ujso
Ca so sobeia mente: del mercado repiso
% Torna contra mj madre: la tu cara preçiosa
Ffazes lo con derecho: sy me eres sannosa
Non uaya mas a mal: que es yda la cosa
Torna sobre teofilo: reygna gloriosa
% Quarenta dias estouo: enesta contençion
Suffria dias e noches: fiera tribulaçion
De al non li menbraua: sy desto solo non
Clamar ala gloriosa: de firme coraçon
% Plogo al rey del çielo: al quarenteno dia
Contendiendo teofilo: ensu tesureria
Apareçiol de noche: sancta uirgo maria
Dixoli fuertes palabras: como qui con fellonja
% Dixoli en que andas: omne de auze dura
Sobre yelo escriues: contiendes en locura
Ffarta so de tu pleyto: das me gran amargura
Eres muy porfidioso: enoyas me syn mesura
% Ffazes petiçiones: locas e syn color
A nos as denegados: busqueste otro sennor
Don renegado malo: de iudas muy peor
Non se por ti qui qujera: rogar al criador
% Yo berguença abria: al mj fijo rogar
Non seria osada: la razon enpeçar
El que tu denegueste: e busquesti pesar
Non nos querra oyr: njn ati perdonar
% Madre dixo teofilo: por dios e caridat
Non cates al mj merito: cata a tu bondat
De quanto que tu dizes: todo dizes uerdat
Ca so suzio e falso: lleno de malueztat
% Repiso so sennora: uala me penjtençia
Essa salua las almas: tal es nuestra creençia
Essa saluo a pedro: que fizo grant fallençia
E lauo alongino: de muy grant ujolencia
% La sancta magdalena: de lazaro hermana
Peccadriz syn mesura: ca fue muger liujana
Esso mesmo te digo: dela egiptiana
Essa sano a ambas: la qui todo mal sana
% Daujd a colpe fizo: tres peccados mortales
Todos feos e suzios: e todos prinçipales
Ffizo su penjtençia: con gemjdos corales
Perdonoli el padre: delos penjtençiales
% Pueblos de njnjue: que eran condempnados
Ffizieron penjtençia: llorando sus peccados
Los fallimjentos todos: fueron lis perdonados
Muchos serian destruydos: que fueron escusados
% Esta razon sennora: tuya es de ueer
Ffaziendo penjtençia: sy me deue ualer
Madre sy tu qujsieres: e fuesse tu plazer
En mj este Juyzio: non deuja paresçer
% Callo elli con tanto: fablo sancta maria
Dixo traes teofilo: rebuelta pleytesia
Bien lieue la mj fonta: bien la perdonaria
Mas alo de mj fijo: bien non me treueria
% Maguer que me negueste: feziste suzio fecho
Qujero te conseiar: de conseio derecho
Torna enel mj fijo: ca te tiene despecho
Ca tiene se de ti: que fue muy mal trecho
% Ruega lo bien de firme: con muy grant femençia
Denjega al diablo: confirma tu creençia
Mucho es piadoso: es de grant conoscençia
El mata el ujujfica: ca es de tal potençia
% Madre dixo teofilo: siempre seas laudada
Pascua fue e grande: quando tu fujste fraguada
Mucho es la mj alma: con esto confortada
Trae la tu palabra: mediçina prouada
% Yo nolo osaria: al tu fijo rogar
Por mj uentura mala: busqueli grant pesar
Pero fio en elli: como deuo fiar
E qujero mj creencia: ati la demostrar
% Creo que es vn dios: e que es trinjdat
Trinjdat en personas: vna la deidat
Non a enlas personas: nulla diuersidat
Padre fijo spiritu: vno son de uerdat
% Creo de ihesu xpisto: enla encarnaçion
Que nasçio de ti madre: por nuestra redemption
Predico el euangelio: despues tomo passion
Enel dia terçero: fizo resurection
% Creo bien firme mente: la su asçension
Creo la postremera: regeneraçion
Quando buenos e malos: reçibran gualardon
Que enbio la gracia: dela consolaçion
% Madre todo lo creo: so ende bien çertano
Quanto que xpisto manda: creer asu xpistiano
Mas so en grant berguença: en mjedo sobeiano
Ca fuy mj sennora: contra el muy ujllano
% A mal omne e suzio: e mal testimonjado
Non me querra oyr: ca non es agujsado
Madre tanto lo temo: que saldria repoyado
Ffincaria nuestro pleyto: mucho empeorado
% Sy bien a de seer: o me quieres prestar
Tu te as eneste pleyto: madre atrabaiar
Otro procurador: non me mandes buscar
Ca por que lo buscasse: no lo podria fallar
% Tu eres para todo: gracias al criador
Por rogar atu padre: tu fijo tu sennor
Que qujera que quieras: o oujeres sauor
Todo lo fara elli: de muy buen amor
% Lo que nunca feziste: en otro peccador
Non sea en teofilo: por el nuestro sennor
Torna me enla gracia: dela tu sancta flor
La flor que tu pariste: syn tacha e syn dolor
% Sennora benedicta: reyna principal
Avn en tu osado: qujero te dezir al
Sy non cobro la carta: que fize por mj mal
Contare que non so quito: del mal dogal
% Dixo sancta maria: don suzio. don maliello
La carta que feziste: con el tu mal cabdiello
Despues la selleste: de tu propio seello
En Jnfierno yaze dentro: en vn renconçiello
% Non querria el mj fijo: por la tu pleytesia
Desçender al Jnfierno: tomar tal romeria
Ca es logar fediondo: fedionda confradia
Solo en someter gelo: seria grant osadia
% Sennora benedicta: entre todas mugeres
Bien lo querra tu fijo: lo que tu bien quisieres
Todo te lo dara: lo que tu li pidieres
Amj berna la carta: sy tu sauor oujeres
% Do qujera quela tenga: el diablo metida
Solo quelo el quiera: sera luego rendida
Sennora que de todos: eres salut e ujda
Non puedo mas rogar te: njn se mas que pida
% Dixo sancta maria: buen confuerto prouado
Ffinca en paz teofilo: ueo te bien lazrado
Yre yo si podiero: recabdar el mandado
Dios lo mande que sea: ayna recapdado
% La madre benedicta: esta razon tractada
Qujtoseli de oios: non podio ueer nada
Pero la uoluntat: tenjala confortada
Ca es el solaz suyo: medicina prouada
% Sy ante fue teofilo: de grant deuoçion
Mucho fue despues ende: de mayor conpunçion
Tres dias e tres noches: estouo en oraçion
Nin comjo njn beujo: njn salio de lection
% Semeiauan sus oios: dos fuentes perennales
Fferia con su cabeça: en los duros cantales
Sus punnos en sus pechos: dauan colpes capdales
Dizia ualas me madre: como a otros uales
% Ualas me madre sancta: oyas los mjs clamores
Que fazes tales cosas: e otras mas mayores
Tu saues la mj cuyta: entiendes mjs dolores
Non me olbides madre: solaz de peccadores
% Mucho lazro teofilo: enesti triduano
Yaziendo en la tierra: orando muy cutiano
Nunca en tanto dias: lazro mas nul xpistiano
En cabo su lazerio: non li cayo en bano
% La reyna de gloria: madre sancta maria
Visitolo de cabo: enel terçero dia
Traxoli saludes: nuebas de alegria
Quales querria todo omne: que yaze enfermeria
% Sepas dixol teofilo: que las tus oraçiones
Los tus gemjdos grandes: las tus afflictiones
Leuadas son al çielo: con grandes proçessiones
Leuaron las los angeles: cantando dulces sones
% Es dela tu fazienda: el mj fijo pagado
El tuerto que toujste: as lo bien emendado
Sy bien perseuerares: commo as enpeçado
Tu pleyto bien es puesto: e muy bien recabdado
% Yo fable entu pleyto: de toda uoluntat
Ffinque los mjs ynoios: ante la su magestat
A te dios perdonado: fecha grant caridat
Conujene tu que seas: firme en tu bondat
% Madre dixo teofilo: de dios nuestro sennor
Por ti me ujene esto: bien so ende saujdor
Qujtas de mal Judicio: vn omne peccador
Que yazria en Jnfierno: con Judas el traydor
% Pero con todo esto: que tu as recapdado
Avn non me seguro: njn bien so pagado
Ffasta que uea la carta: e cobre el dictado
La que fiz quando ouj: al tu fijo negado
% Madre sy yo oujesse: la cartiella cobrada
Et dentro en vn fuego: la ujdiesse quemada
Sy quier luego muriesse: yo non daria nada
Ca mal esta sennora: mj alma ençerrada
% Madre bien se que eres: deste pleyto enoiada
Mas sy tu me falleçes: non me tengo a nada
Sennora tu que esta cosa: as empeçada
Ffes me render la carta: sera bien acabada
% Non fincara por esso: dixo la gloriosa
Non finque por tan poco: enpeçada la cosa
Qujtose li delante: la reyna preçiosa
Ffue buscar esta carta: de guisa presurosa
% Alegrose teophilo: que yazia quebrantado
Non era mjrabilla: ca era muy lazrado
Torno ensu estudio: el que auja usado
Nunca fue eneste mundo: confessor mas penado
% Torno ensu estudio: afazer su penjtençia
En comer en beuer: tener grant abstinençia
Tenja enla gloriosa: toda su creençia
Quele daria por ella: dios la su buena querençia
% Enla noche terçera: yazia el adormjdo
Que suffria grant martirio: auja poco sentido
Vinoli la gloriosa: con recapdo cumplido
Con su carta en mano: queda syn todo roydo
% La esposa de xpisto: ponzela e parida
Echogela de suso: dioli vna ferida
Recudio don teophilo: torno de muerte aujda
Ffallo en su regaço: la carta mal metida
% Con esto fue teofilo: guarido e loçano
Que uedia la cartiella: tornada asu mano
Alli touo que era: dela fiebre bien sano
Apreto bien la carta: cunplio su triduano
% El confessor teofilo: ouo grant alegria
Quando touo la carta: en su podestadia
Rendio gracias a dios: e a sancta maria
Ca ella adobara: toda la pleytesia
% Dizia. sennora buena: siempre seas laudada
Siempre seas bendicha: siempre glorificada
Para los peccadores: eres buena prouada
Qual nunca naçio otra: tan dulze njn ubiada
% Siempre seas bendicha: el tu fructo laudado
Sancto es el tu nonbre: mas el suyo medrado
Tu me saqueste madre: del pozo diablado
Do siempre sine fine: yazria enfogado
% Sennora benedicta: madre sancta maria
Quanto telo gradezco: dezir non lo sabria
Madre tu me da seso: saber e conosçia
Por onde laudar te pueda: ca mucho lo querria
% Reygna poderosa: delos fechos honrrados
Que siempre te trauaias: en saluar los errados
Tu me gana sennora: perdon de mjs peccados
Que loe digna mente: los tus bienes granados
% Madre del rey de gloria: por la tu piadat
Alimpia los mjs labros: e la mj uolumtat
Que pueda digna mente: laudar la tu bondat
Ca as sobre mj fecha: muy grant caridat
% Otro dia mannana: que cuntio esta cosa
Que traxo la carta: la madre gloriosa
Era dia domjngo: vna feria sabrosa
En quj la gente xpistiana: toda anda gradosa
% Vino el pueblo todo: ala mjssa oyr
Tomar pan bendicto: la agua reçibir
Queriala el obispo: de la ujlla dezir
Queria el omne bueno: su offiçio conplir
% El confessor teofilo: vn lazrado xpistiano
Ffue para la iglesia: con su carta en mano
Posose alos piedes: del buen mjssa+cantano
Confesso su proçesso: tardio e temprano
% Ffizo su confession: pura e uerdadera
Como fizo su ujda: dela edat primera
Despues. como en+ujdia: lo saco de carrera
Quelo fizo çegar: de estranna manera
% Como fue al Judio: vn trufan renegado
Como li dio conseio: suzio e desgujsado
Como con el diablo: ouo pleyto taiado
E como fue por carta: el pleyto confirmado
% Como por la gloriosa: cobro aquel dictado
El que con su siello: oujera seellado
Non dexo de dezir: menudo njn granado
Que nolo dixo todo: por que auja passado
% Demostroli la carta: que en punno tenia
En que toda la fuerça: del mal pleyto yazia
Sanctiguose el obispo: que tal cosa uedia
Tanto era grant cosa: que abes lo creya
% Ite mjssa est dicha: la mjssa acabada
Era toda la gente: por irse saborgada
Ffizo sygno el obispo: con su magno sagrada
Ffinco la gente toda: como estaua posada
% Oyt dixo uarones: vna fiera fazanna
Nunca eneste mundo: la oyestes tamanna
Veredes el diablo: que trae mala manna
Los que non seli guardan: tan mal quelos enganna
% Esti nuestro canonjgo: e nuestro conpannero
Moujolo su locura: vn falso consegero
Ffue buscar al diablo: sabidor e artero
Por cobrar vn offiçio: que toujera primero
% Sopolo engannar: el falso traydor
Dixoli que negasse: a xpisto su sennor
E a sancta maria: que fue buena soror
E tornar le ya luego: en toda su honor
% Otorgogelo esti: mezquino peccador
Ffizo con el su carta: esto fue lo peor
Con su siello mjsmo: robro essa lauor
De tal amjgo guarde nos: dios nuestro sennor
% Dios que siempre desea: salut de peccadores
Que por anos saluar: suffrio grandes dolores
Non qujso que ganassen: essas tales labores
Ca eran barbechadas: de malos labradores
% Sy la uirgo gloriosa: nol oujesse ualido
Era el azedoso: dura mente torçido
Mas la su sancta graçia: aueli acorrido
A cobrada la carta: sy non. seria perdido
% Yo la tengo en punno: podedes la ueer
Esto non yaze en dubda: deuedes lo creer
Onde deuemos todos: a dios gracias render
E ala sancta uirgo: quele qujso ualer
% Rendieron todos gracias: mugeres e barones
Ffizieron grandes laudes: e grandes proçessiones
Plorauan delos oios: diziendo bendiçiones
Ala madre gloriosa: bona todas sazones
% El te deum laudamus: fue alta mente cantado
Tibi laus tibi gloria: fue ter bien recitado
Dizian salue regina: cantauanla de grado
E otros cantos dulçes: de son e de dictado
% Despues. mando el obispo: fazer muy gran foguera
Vediendolo el pueblo: que enla iglesia era
Echo esta carta: dentro enla calera
Ardio. torno çenjza: pargamjno e çera
% Desque el pueblo: ouo tenjdo el clamor
La carta fue quemada: gracias al criador
Reçebio corpus dominj: el sancto confessor
Vediendolo el pueblo: que estaua derredor
% Adiesso que teofilo: vn cuerpo martiriado
Resçibio corpus dominj: e fue bien confessado
Ffue a oio del pueblo: de claridat çercado
De vn resplendor tan fito: que non seria asmado
% Ffue el pueblo çertero: que era omne sancto
Era de grant merito: por quien fazia dios tanto
E dios quj lo cubria: de tan precioso manto
e tomaua el diablo: enello grant quebranto
% Reluzia la su cara: tales rayos echaua
Como la de moyses: quando la ley portaua
O como sant andres: quando en cruz estaua
El criador enesto: poca honrra nol daua
% Quando esto ujdieron: los pueblos e las gentes
Que salian de su cara: tales rayos luzientes
Cantaron otras laudes: otros cantos rezientes
En laudar la gloriosa: todos eran ardientes
% Aturo bien teofilo: ensu contemplaçion
Nol moujo uana gloria: njn cogio elacion
Torno ala iglesia: do ujo la ujsion
Nunca fue mas deuoto: en njnguna sazon
% Entendio el omne bueno: dios lo fizo çertero
Queli uenja bien çerca: el dia postrimero
Partio quanto auja: non li finco dinero
Diolo todo apobres: fizo buen semençero
% Pidio perdon a todos: los dela uezindat
Perdonaronli todos: de buena uoluntat
Beso mano al obispo: fizo grant honestat
Ffino al terçero dia: fizol dios piadat
% Tres dias solos ujsco: desque fue comulgado
Desque el cartalario: fue cenjza tornado
Murio enla iglesia: do fuera ujsitado
Ffue en esse logar mjsmo: el cuerpo soterrado
% Assy fino teofilo: el bien auenturado
El yerro que fiziera: dios sea ende laudado
Bien lo emendo todo: fizo a dios pagado
Valiendol la gloriosa: la que aya buen grado
% Sennores tal mjraglo: qual auedes oydo
Non deuemos por nada: echarlo en olbido
Sy non seremos todos: omnes de mal sentido
Que non auemos seso: natural njn conplido
% Assy lo dize sant pablo: el buen predicador
Que fue leal uassallo: de dios nuestro sennor
Que todas las leyendas: que son del criador
Todas salud predican: del omne peccador
% Nos enesto podemos: entender e asmar
Quanto uale penjtençia: quj la saue guardar
Sy non fuesse por ella: podemos lo Jurar
Que fuera don teofillo: ydo a mal logar
% Sy la madre gloriosa: que le qujso ualer
Essa non entendiesse: no lo uernja ueer
Mas quj amj qujsiere: escuchar e creer
Viua en penjtençia: puede saluo seer
% Amjgos si queredes: uuestras almas saluar
Sy uos el mj conseio: quisieredes tomar
Ffazed conffession uera: non querades tardar
E tomat penjtençia: pensat la de guardar
% Quiera lo ihesu xpisto: ela uirgo gloriosa
Syn la qual non se faze: njnguna buena cosa
Que assy mantengamos: esta ujda lazrosa
Que ganemos la otra: durable e lumbrosa Amen
% La madre gloriosa: de çielos reygna
Que fue ateofilo: tan prestable madrina
Ella nos sea guarda: enesta luz mezquina
Que caer non podamos: enla mala ruyna
% Madre del tu gonçalo: seas remenbrador
Que delos tus mjraglos: fue enterpretador
Tu fes por el sennora: preçes al criador
Ca el tu priujlegio: uale apeccador
Tu li gana la graçia: de dios nuestro sennor. Amen
